ATCATTAGGATGCCACCAC -> TCATTAGGATGCCACCACA
GTCCACTCCGCGTGCAACC -> TCCACTCCGCGTGCAACCT
TAGTCTCATGTGTTTCGGT -> AGTCTCATGTGTTTCGGTG
GGCCAATACCCGGACGGAT -> GCCAATACCCGGACGGATA
TCAGCCTGTTACCACCTCT -> CAGCCTGTTACCACCTCTC
AGGTATATTCTTTCATATG -> GGTATATTCTTTCATATGG
TATGCCGCCATACTCGTAA -> ATGCCGCCATACTCGTAAG
TGGGAATTGTCTACAAACC -> GGGAATTGTCTACAAACCT
CTATGGCGTACGGGAGTGT -> TATGGCGTACGGGAGTGTG
GACGACACGATACGGAGTA -> ACGACACGATACGGAGTAA
AAGACTCCACGTGAGCCCT -> AGACTCCACGTGAGCCCTT
ATTTGGACACCGCAGTTAT -> TTTGGACACCGCAGTTATA
CTTTCATATGGCGGTATGA -> TTTCATATGGCGGTATGAC
CCCCCTATTCCGCCAGAAG -> CCCCTATTCCGCCAGAAGA
GCTGGTCTTGCGCAACTAC -> CTGGTCTTGCGCAACTACA
GGTATATTCTTTCATATGG -> GTATATTCTTTCATATGGC
AATCACTATAGATATGCAT -> ATCACTATAGATATGCATG
CAGAATAAAACTCTTAAAG -> AGAATAAAACTCTTAAAGG
TATTCTTTCATATGGCGGT -> ATTCTTTCATATGGCGGTA
CTGGCAACATCCCCGGATA -> TGGCAACATCCCCGGATAA
CGCGGGCAGAAGACCGGAT -> GCGGGCAGAAGACCGGATC
ATTCTAATAAAGCTAGGGT -> TTCTAATAAAGCTAGGGTA
TCCTGAGGGGTATGGGAAT -> CCTGAGGGGTATGGGAATT
TAGTACAACCAGAATAAAA -> AGTACAACCAGAATAAAAC
TGCAGGCCTAGGCAGAGTC -> GCAGGCCTAGGCAGAGTCT
AGTGTGCATTTATAAGCAC -> GTGTGCATTTATAAGCACG
ATTCTCATTAGGATGCCAC -> TTCTCATTAGGATGCCACC
TTCGAGCTAAGATTGGTTC -> TCGAGCTAAGATTGGTTCC
TCCACTCCGCGTGCAACCT -> CCACTCCGCGTGCAACCTG
AGCTATGCAGGCCTAGGCA -> GCTATGCAGGCCTAGGCAG
TGCCGTCGCTGGCAACATC -> GCCGTCGCTGGCAACATCC
TAATTGCCGTCGCTGGCAA -> AATTGCCGTCGCTGGCAAC
CTTTCATGCGGCGGGTATT -> TTTCATGCGGCGGGTATTT
TTTAAAAATAAATTGACAA -> TTAAAAATAAATTGACAAG
CATTAGGATGCCACCACGA -> ATTAGGATGCCACCACGAC
AGCTTCCAGTCGAGCAGAG -> GCTTCCAGTCGAGCAGAGA
GGCGTGAAGTTCTATTATT -> GCGTGAAGTTCTATTATTT
CAGTCTACCTGCGTAAAGG -> AGTCTACCTGCGTAAAGGT
CAGGGATCCAATTACCCCG -> AGGGATCCAATTACCCCGA
GTGTTTCGGTGAGGTGAGC -> TGTTTCGGTGAGGTGAGCT
GTAAAAATCTGTATTTTAT -> TAAAAATCTGTATTTTATC
ATAGTACAACCAGAATAAA -> TAGTACAACCAGAATAAAA
GCAGAAGACCGGATCAAAA -> CAGAAGACCGGATCAAAAG
TATCTGTCCTTGAATCAAT -> ATCTGTCCTTGAATCAATA
ACCCCTAGATGAGGAATAG -> CCCCTAGATGAGGAATAGT
ACAAAGATTTAAGCGCACC -> CAAAGATTTAAGCGCACCC
TATTCCGCCAGAAGAACAG -> ATTCCGCCAGAAGAACAGT
CTCACTAAACGTCCTATAC -> TCACTAAACGTCCTATACT
CGAAATTTAAATTCCTGCT -> GAAATTTAAATTCCTGCTT
ATGGCGGTATGACTAGGCG -> TGGCGGTATGACTAGGCGG
CCACCAGCTTTAAGCTCGG -> CACCAGCTTTAAGCTCGGA
TAATATGTCGTGTAAGTGC -> AATATGTCGTGTAAGTGCA
AGATCGTCTCAGTCATTAG -> GATCGTCTCAGTCATTAGG
ATTTTTCGTAGTTGGATCT -> TTTTTCGTAGTTGGATCTC
CGGCAAAGCGTCCACTCCG -> GGCAAAGCGTCCACTCCGC
CAAGTGCAGTGTACTGTCC -> AAGTGCAGTGTACTGTCCT
ATAAAACTCTTAAAGGGCC -> TAAAACTCTTAAAGGGCCT
CTACGCAAGGTCGCGCGGC -> TACGCAAGGTCGCGCGGCT
GTGCATTTATAAGCACGAC -> TGCATTTATAAGCACGACA
TATAGGTCGTTCATGATGC -> ATAGGTCGTTCATGATGCT
TCGACGGGCCGTAATGTGT -> CGACGGGCCGTAATGTGTC
GTGTGCATTTATAAGCACG -> TGTGCATTTATAAGCACGA
TCGTCCCTTATACGCAGAT -> CGTCCCTTATACGCAGATG
TAGGATGCCACCACGACGT -> AGGATGCCACCACGACGTT
AACATCCCCGGATAAACGA -> ACATCCCCGGATAAACGAG
TGAAATAGTACAACCAGAA -> GAAATAGTACAACCAGAAT
ACGACACGATACGGAGTAA -> CGACACGATACGGAGTAAT
CGGAGTAATGACAGTCTAC -> GGAGTAATGACAGTCTACC
ACACGACACCCCTAGATGA -> CACGACACCCCTAGATGAG
ATAATTGCCGTCGCTGGCA -> TAATTGCCGTCGCTGGCAA
CAAACGTCAAAGCGACGAC -> AAACGTCAAAGCGACGACA
GAGCCCTTAGACTACCTAT -> AGCCCTTAGACTACCTATG
GTCCTTGAATCAATAGAGG -> TCCTTGAATCAATAGAGGT
ACGTTAGCAGCATGTACAT -> CGTTAGCAGCATGTACATA
CAAGCAAGTGCAGTGTACT -> AAGCAAGTGCAGTGTACTG
TAAGAGCTTCATTACGGAG -> AAGAGCTTCATTACGGAGG
AGGATGCCACCACCAGCTT -> GGATGCCACCACCAGCTTT
ACTGTTTAACACAGATCAG -> CTGTTTAACACAGATCAGA
TTTCATGCGGCGGGTATTT -> TTCATGCGGCGGGTATTTA
CTATAACACTTCATTAGGA -> TATAACACTTCATTAGGAT
TTTAGATGGCCGTTGCACT -> TTAGATGGCCGTTGCACTC
AGATTTAAGCGCACCCATT -> GATTTAAGCGCACCCATTA
TCGGCGCCACTTCGTGTCG -> CGGCGCCACTTCGTGTCGG
CATCATAATTGCCGTCGCT -> ATCATAATTGCCGTCGCTG
TAACCCAAGCTCTTCGTAA -> AACCCAAGCTCTTCGTAAG
GGCCTAGGCAGAGTCTATG -> GCCTAGGCAGAGTCTATGT
AACTGGTTCTACTGGCGCC -> ACTGGTTCTACTGGCGCCT
GCTCAATGTGGAGTATAAC -> CTCAATGTGGAGTATAACG
ACCACGTCACGCTCACCCG -> CCACGTCACGCTCACCCGG
AGGGCCTACAACTCTCCCT -> GGGCCTACAACTCTCCCTT
TATCGGCACATGTACACAG -> ATCGGCACATGTACACAGT
TCGAATGTTAGTAAATGCC -> CGAATGTTAGTAAATGCCA
CCACGTCGTGATCCCCTGT -> CACGTCGTGATCCCCTGTC
TCTCCCTTGTCCGGATATC -> CTCCCTTGTCCGGATATCG
GACACCGCAGTTATAATAT -> ACACCGCAGTTATAATATG
ACGACGTTTGTTATCGGAG -> CGACGTTTGTTATCGGAGG
AGCAGCATGTACATAAATA -> GCAGCATGTACATAAATAC
TAGGGAGGACGAAATTTAA -> AGGGAGGACGAAATTTAAA
ATGACTAGGCGGGCGCAAT -> TGACTAGGCGGGCGCAATC
AAAGCGTCCACTCCGCGTG -> AAGCGTCCACTCCGCGTGC
ACTAAACGTCCTATACTAC -> CTAAACGTCCTATACTACC
ATGTACATAAATACGGATG -> TGTACATAAATACGGATGA
ATAAGCACGACAATCACTA -> TAAGCACGACAATCACTAT
TAGGATGCCACCACTTGTA -> AGGATGCCACCACTTGTAA
AGGTCATGCGAAATTGAGG -> GGTCATGCGAAATTGAGGT
ATCGGAGGTATATTCTTTC -> TCGGAGGTATATTCTTTCA,TCGGAGGTATATTCTTTCA
CCGCCATACTCGTAAGCGG -> CGCCATACTCGTAAGCGGA
GTTCTATTATTTTCCAGAT -> TTCTATTATTTTCCAGATA
GGGCAGAAGACCGGATCAA -> GGCAGAAGACCGGATCAAA
TTCGTAAGCCTTTATGGCC -> TCGTAAGCCTTTATGGCCA
AGCTCTAGGGACGGTTAGT -> GCTCTAGGGACGGTTAGTG
TAGGGTAGCAAACTCTGAT -> AGGGTAGCAAACTCTGATC
CTTTGATTAAGAGCTTCAT -> TTTGATTAAGAGCTTCATT
AGATGGCCGTTGCACTCCC -> GATGGCCGTTGCACTCCCC
CGTGTAAGTGCAAACGTCA -> GTGTAAGTGCAAACGTCAA
GGAGGACGAAATTTAAATT -> GAGGACGAAATTTAAATTC
AAAATCTGTATTTTATCAT -> AAATCTGTATTTTATCATA
GCATCATTAGGATGCCACC -> CATCATTAGGATGCCACCA
AAATACGGATGATTTACAC -> AATACGGATGATTTACACG
ACATGTACACAGTTCTGGG -> CATGTACACAGTTCTGGGC
ATTATTTTCCAGATAGTCT -> TTATTTTCCAGATAGTCTC
CGGATGATTTACACGACAC -> GGATGATTTACACGACACC
CCATCCATCGACTAATAGG -> CATCCATCGACTAATAGGG
ATTAGGATGCCACCACCAG -> TTAGGATGCCACCACCAGC
ATGTTAATCGGCGCCACTT -> TGTTAATCGGCGCCACTTC
TAAATCTCCCTACGCAAGG -> AAATCTCCCTACGCAAGGT
CACCACATGTGACGCCATC -> ACCACATGTGACGCCATCG
ATTGCCGTCGCTGGCAACA -> TTGCCGTCGCTGGCAACAT
TAAATACGGATGATTTACA -> AAATACGGATGATTTACAC
TATAATATGTCGTGTAAGT -> ATAATATGTCGTGTAAGTG
CCCCTATTCCGCCAGAAGA -> CCCTATTCCGCCAGAAGAA
GCCTGTTACCACCTCTCGA -> CCTGTTACCACCTCTCGAT
TGACAGTCTACCTGCGTAA -> GACAGTCTACCTGCGTAAA
GGCCATCAGCCTGTTACCA -> GCCATCAGCCTGTTACCAC
ATACCCGGACGGATACCCG -> TACCCGGACGGATACCCGC
TCCCTGAGGAGTATAATTC -> CCCTGAGGAGTATAATTCC
GAACTGGTTCTACTGGCGC -> AACTGGTTCTACTGGCGCC
CGCTCACCCGGCTGTGGTC -> GCTCACCCGGCTGTGGTCC
AAGCCTTTATGGCCAATAC -> AGCCTTTATGGCCAATACC
GACGCATAGACACAACTCC -> ACGCATAGACACAACTCCC
TCTTCTCACTAAACGTCCT -> CTTCTCACTAAACGTCCTA
GATGTACCCCCAAAGGGTC -> ATGTACCCCCAAAGGGTCC
TATGATTGCTAACATCAAA -> ATGATTGCTAACATCAAAT
TGTAAGGCGGTCGGAGGTA -> GTAAGGCGGTCGGAGGTAT
CACGTCGTGATCCCCTGTC -> ACGTCGTGATCCCCTGTCA
ACTTTAATTTGGACACCGC -> CTTTAATTTGGACACCGCA
AATTTAAATTCCTGCTTTG -> ATTTAAATTCCTGCTTTGC
TGTGTTTCGGTGAGGTGAG -> GTGTTTCGGTGAGGTGAGC
ATTTTATCATACGTTAGCA -> TTTTATCATACGTTAGCAG
GAGATGAACTGGTTCTACT -> AGATGAACTGGTTCTACTG
GTCATGAGATGAACTGGTT -> TCATGAGATGAACTGGTTC
CTGAAATAGTACAACCAGA -> TGAAATAGTACAACCAGAA
CTAGTCCCCCTATTCCGCC -> TAGTCCCCCTATTCCGCCA
GCCACTTCGTGTCGGTGCA -> CCACTTCGTGTCGGTGCAT
AGCAAACTCTGATCTAGAT -> GCAAACTCTGATCTAGATG
AATCTGTATTTTATCATAC -> ATCTGTATTTTATCATACG
AGCTTTGATTAAGAGCTTC -> GCTTTGATTAAGAGCTTCA
ACCACGACGTTTGTTATCG -> CCACGACGTTTGTTATCGG
AGGACCGCGGACAACAGGT -> GGACCGCGGACAACAGGTC
GTGTAAGTGCAAACGTCAA -> TGTAAGTGCAAACGTCAAA
GCCTATAAAGGTTCTGAAA -> CCTATAAAGGTTCTGAAAT
ATTGCTAACATCAAATCTT -> TTGCTAACATCAAATCTTG
CGTTAGCAGCATGTACATA -> GTTAGCAGCATGTACATAA
CATAGACACAACTCCCTAG -> ATAGACACAACTCCCTAGA
GCACTCCCCGGCCATCAGC -> CACTCCCCGGCCATCAGCC
GTCGTTCATGATGCTCAAT -> TCGTTCATGATGCTCAATG
ACTCGTAAGCGGAGACCAC -> CTCGTAAGCGGAGACCACG
TGGTCTTGCGCAACTACAC -> GGTCTTGCGCAACTACACA
GGATACCCGCCTGACCTTC -> GATACCCGCCTGACCTTCC
TAACGCAATTATATCTGTC -> AACGCAATTATATCTGTCC
TTTAAGCGCACCCATTACT -> TTAAGCGCACCCATTACTA
AGCTGCCTTGGATCGCATC -> GCTGCCTTGGATCGCATCA
TGGTTCTACTGGCGCCTGG -> GGTTCTACTGGCGCCTGGT
GAGGTATATTCTTTCATAT -> AGGTATATTCTTTCATATG
TTATAAGCACGACAATCAC -> TATAAGCACGACAATCACT
TGCTCAATGTGGAGTATAA -> GCTCAATGTGGAGTATAAC
GATGATTTACACGACACCC -> ATGATTTACACGACACCCC
ACGCACTAAATCTCCCTAC -> CGCACTAAATCTCCCTACG
GCGCAACTACACACCGACA -> CGCAACTACACACCGACAC
GTCGAGCAGAGACGCGTTT -> TCGAGCAGAGACGCGTTTA
GCACGGCAGACTCCTGAGG -> CACGGCAGACTCCTGAGGG
GACCACGTCGTGATCCCCT -> ACCACGTCGTGATCCCCTG
ATGTGGAGTATAACGCAAT -> TGTGGAGTATAACGCAATT
ATGTACACAGTTCTGGGCC -> TGTACACAGTTCTGGGCCG
TGTGACGCCATCGGAGGTA -> GTGACGCCATCGGAGGTAT
GTAGTTGGATCTCGACGCA -> TAGTTGGATCTCGACGCAT
CCCTTGTCCGGATATCGGC -> CCTTGTCCGGATATCGGCA
GCGGACAACAGGTCATGCG -> CGGACAACAGGTCATGCGA
CGAATGTTAGTAAATGCCA -> GAATGTTAGTAAATGCCAG
ATCTAGATGATCATAAAGC -> TCTAGATGATCATAAAGCA
ATTTAGATGGCCGTTGCAC -> TTTAGATGGCCGTTGCACT
GATACCCGCCTGACCTTCC -> ATACCCGCCTGACCTTCCC
ACGACAATCACTATAGATA -> CGACAATCACTATAGATAT
TGTCACAACCCTCGATACC -> GTCACAACCCTCGATACCG
CCCCAAGCAAGTGCAGTGT -> CCCAAGCAAGTGCAGTGTA
TATAATTCCCTCGTCCCTT -> ATAATTCCCTCGTCCCTTA
GCACTAAATCTCCCTACGC -> CACTAAATCTCCCTACGCA
TGCCACCACTTGTAAGGCG -> GCCACCACTTGTAAGGCGG
CCCGAAAGACTCCACGTGA -> CCGAAAGACTCCACGTGAG
AATTGCCGTCGCTGGCAAC -> ATTGCCGTCGCTGGCAACA
TAGGATGCCACCACCAGCT -> AGGATGCCACCACCAGCTT
AGTGCAGTGTACTGTCCTA -> GTGCAGTGTACTGTCCTAC
GAGTATAATTCCCTCGTCC -> AGTATAATTCCCTCGTCCC
TGGTCCATAATATCAGTGT -> GGTCCATAATATCAGTGTA
ACGAAATTTAAATTCCTGC -> CGAAATTTAAATTCCTGCT
CTTTAATTTGGACACCGCA -> TTTAATTTGGACACCGCAG
TTCGGTGAGGTGAGCTGCC -> TCGGTGAGGTGAGCTGCCT
CCAATACCCGGACGGATAC -> CAATACCCGGACGGATACC
CCTTCCCTATAACACTTCA -> CTTCCCTATAACACTTCAT
TCGAGCAGAGACGCGTTTA -> CGAGCAGAGACGCGTTTAT
GCGTCCACTCCGCGTGCAA -> CGTCCACTCCGCGTGCAAC
CGAGCATCATAATTGCCGT -> GAGCATCATAATTGCCGTC
CTTCATTACGGAGGCGTGA -> TTCATTACGGAGGCGTGAA
CGGATAAACGAGCTTTGAT -> GGATAAACGAGCTTTGATT
ATACGTTAGCAGCATGTAC -> TACGTTAGCAGCATGTACA
TCATGATGCTCAATGTGGA -> CATGATGCTCAATGTGGAG
TTGCTAACATCAAATCTTG -> TGCTAACATCAAATCTTGC
CGGTCGGAGGTATATTCTT -> GGTCGGAGGTATATTCTTT
GTTTCGGTGAGGTGAGCTG -> TTTCGGTGAGGTGAGCTGC
ACACGATACGGAGTAATGA -> CACGATACGGAGTAATGAC
CGTCACGCTCACCCGGCTG -> GTCACGCTCACCCGGCTGT
CCTGATACGCTCTGTAACT -> CTGATACGCTCTGTAACTT
GATTTACACGACACCCCTA -> ATTTACACGACACCCCTAG
ACAGTCTACCTGCGTAAAG -> CAGTCTACCTGCGTAAAGG
GGCAACATCCCCGGATAAA -> GCAACATCCCCGGATAAAC
TATTTTCCAGATAGTCTCA -> ATTTTCCAGATAGTCTCAT
TAACACAGATCAGACCGTT -> AACACAGATCAGACCGTTG
TACCTACTTCTAAATCGCG -> ACCTACTTCTAAATCGCGG
ACCTACTTCTAAATCGCGG -> CCTACTTCTAAATCGCGGG
CCGCCAGAAGAACAGTTGA -> CGCCAGAAGAACAGTTGAC
TTGAGGTTCGAGCTAAGAT -> TGAGGTTCGAGCTAAGATT
TCATACGTTAGCAGCATGT -> CATACGTTAGCAGCATGTA
ATAGTCGTGTCCCAGTCGG -> TAGTCGTGTCCCAGTCGGG
TAACACTTCATTAGGATGC -> AACACTTCATTAGGATGCC
ATCAAATCTTGCCGGCCCA -> TCAAATCTTGCCGGCCCAT
GAATCAATAGAGGTAAATG -> AATCAATAGAGGTAAATGG
AACTGGAGGACCGCGGACA -> ACTGGAGGACCGCGGACAA
GCGGAGACCACGTCGTGAT -> CGGAGACCACGTCGTGATC
GCCCTTAGACTACCTATGG -> CCCTTAGACTACCTATGGC
ATGCGGCGGGTATTTAGAT -> TGCGGCGGGTATTTAGATG
AAAAATAAATTGACAAGAG -> AAAATAAATTGACAAGAGC
AGAAGACCGGATCAAAAGA -> GAAGACCGGATCAAAAGAT
GTGGTCCATAATATCAGTG -> TGGTCCATAATATCAGTGT
ATATCGGCACATGTACACA -> TATCGGCACATGTACACAG
TTGGATCTCGACGCATAGA -> TGGATCTCGACGCATAGAC
ACCGGATCAAAAGATCGTC -> CCGGATCAAAAGATCGTCT
TATATTCTTTCAGCTCAGG -> ATATTCTTTCAGCTCAGGA
ACTTCTAAATCGCGGGCAG -> CTTCTAAATCGCGGGCAGA
TTCATTAGGATGCCACCAC -> TCATTAGGATGCCACCACT
GTGCCGAGCATCATAATTG -> TGCCGAGCATCATAATTGC
GGTATGACTAGGCGGGCGC -> GTATGACTAGGCGGGCGCA
AATTATGTTAATCGGCGCC -> ATTATGTTAATCGGCGCCA
AGCGTCCACTCCGCGTGCA -> GCGTCCACTCCGCGTGCAA
TTGTCTACAAACCTAGTTA -> TGTCTACAAACCTAGTTAA
AAGCGTCCACTCCGCGTGC -> AGCGTCCACTCCGCGTGCA
GGAGGTATATTCTTTCAGC -> GAGGTATATTCTTTCAGCT
GTTGCACTCCCCGGCCATC -> TTGCACTCCCCGGCCATCA
CGCAACTACACACCGACAC -> GCAACTACACACCGACACT
CTGTCACAACCCTCGATAC -> TGTCACAACCCTCGATACC
TAGTTAATTATGTTAATCG -> AGTTAATTATGTTAATCGG
AGCTTCATTACGGAGGCGT -> GCTTCATTACGGAGGCGTG
CAAACAAGCTCTAGGGACG -> AAACAAGCTCTAGGGACGG
GAACAGTTGACAAACAAGC -> AACAGTTGACAAACAAGCT
TTTAATTTGGACACCGCAG -> TTAATTTGGACACCGCAGT
CTTTCAGTAAAAATATCGA -> TTTCAGTAAAAATATCGAA
ATATCTGTCCTTGAATCAA -> TATCTGTCCTTGAATCAAT
TACTCGTAAGCGGAGACCA -> ACTCGTAAGCGGAGACCAC
CAGTTGACAAACAAGCTCT -> AGTTGACAAACAAGCTCTA
AACTCTCCCTTGTCCGGAT -> ACTCTCCCTTGTCCGGATA
ATATCAGTGTAAATAAAGC -> TATCAGTGTAAATAAAGCT
TACATAAATACGGATGATT -> ACATAAATACGGATGATTT
GTATATTCTTTCATGCGGC -> TATATTCTTTCATGCGGCG
CACCACCAGCTTTAAGCTC -> ACCACCAGCTTTAAGCTCG
CATTCTAATAAAGCTAGGG -> ATTCTAATAAAGCTAGGGT
TAGTTGGATCTCGACGCAT -> AGTTGGATCTCGACGCATA
GTTATGTCGATGCCTGCGT -> TTATGTCGATGCCTGCGTG
CCGGCCATCAGCCTGTTAC -> CGGCCATCAGCCTGTTACC
ATAAACGAGCTTTGATTAA -> TAAACGAGCTTTGATTAAG
AAGCTCTTCGTAAGCCTTT -> AGCTCTTCGTAAGCCTTTA
GAACGCACTAAATCTCCCT -> AACGCACTAAATCTCCCTA
GCAACATCCCCGGATAAAC -> CAACATCCCCGGATAAACG
CCCAAGCAAGTGCAGTGTA -> CCAAGCAAGTGCAGTGTAC
ACACCACGTCACGCTCACC -> CACCACGTCACGCTCACCC
GACAATCACTATAGATATG -> ACAATCACTATAGATATGC
GATCGGAATGTAGCATTCT -> ATCGGAATGTAGCATTCTA
AGAGTCTATGTACTAGTGT -> GAGTCTATGTACTAGTGTA
CCTTGTCCGGATATCGGCA -> CTTGTCCGGATATCGGCAC
AAACAAGCTCTAGGGACGG -> AACAAGCTCTAGGGACGGT
CGTGAGCCCTTAGACTACC -> GTGAGCCCTTAGACTACCT
GACAAAGATTTAAGCGCAC -> ACAAAGATTTAAGCGCACC
CTCGTCCCTTATACGCAGA -> TCGTCCCTTATACGCAGAT
CTATTATTTTCCAGATAGT -> TATTATTTTCCAGATAGTC
ACAATCACTATAGATATGC -> CAATCACTATAGATATGCA
GCGCACCCATTACTACCTA -> CGCACCCATTACTACCTAC
CGAGCTTTGATTAAGAGCT -> GAGCTTTGATTAAGAGCTT
AAACACCGGGTTATGTCGA -> AACACCGGGTTATGTCGAT
AATCAATAGAGGTAAATGG -> ATCAATAGAGGTAAATGGA
CAACTCCCTAGAAAAAAGA -> AACTCCCTAGAAAAAAGAG
GACGTTTGTTATCGGAGGT -> ACGTTTGTTATCGGAGGTA
CCACCACTTGTAAGGCGGT -> CACCACTTGTAAGGCGGTC
TAAATTGACAAGAGCACGG -> AAATTGACAAGAGCACGGC
TAGATATGCATGAACACGA -> AGATATGCATGAACACGAA
AAATCTGTATTTTATCATA -> AATCTGTATTTTATCATAC
GGATAAACGAGCTTTGATT -> GATAAACGAGCTTTGATTA
CATCAGCCTGTTACCACCT -> ATCAGCCTGTTACCACCTC
AGTCTACCTGCGTAAAGGT -> GTCTACCTGCGTAAAGGTA
CTAAACGTCCTATACTACC -> TAAACGTCCTATACTACCG
ATATGTCGTGTAAGTGCAA -> TATGTCGTGTAAGTGCAAA
AGTTATAATATGTCGTGTA -> GTTATAATATGTCGTGTAA
TCGTAAATATGAACACCAC -> CGTAAATATGAACACCACG
GCCACCACCAGCTTTAAGC -> CCACCACCAGCTTTAAGCT
TGACAAACAAGCTCTAGGG -> GACAAACAAGCTCTAGGGA
CCACTTGTAAGGCGGTCGG -> CACTTGTAAGGCGGTCGGA
GTATAATTCCCTCGTCCCT -> TATAATTCCCTCGTCCCTT
ATATGATTGCTAACATCAA -> TATGATTGCTAACATCAAA
TTAGCAGCATGTACATAAA -> TAGCAGCATGTACATAAAT
ACCCGGACGGATACCCGCC -> CCCGGACGGATACCCGCCT
AACAAGCTCTAGGGACGGT -> ACAAGCTCTAGGGACGGTT
GTCACGCTCACCCGGCTGT -> TCACGCTCACCCGGCTGTG
CCGTCGCTGGCAACATCCC -> CGTCGCTGGCAACATCCCC
TAACCTTACTTGGTTTGAA -> AACCTTACTTGGTTTGAAC
ATAACACTTCATTAGGATG -> TAACACTTCATTAGGATGC
CTGTGAGCTTCCAGTCGAG -> TGTGAGCTTCCAGTCGAGC
CATTACTACCTACTTCTAA -> ATTACTACCTACTTCTAAA
GTTACCACCTCTCGATAAA -> TTACCACCTCTCGATAAAG
CGTGCAACCTGATACGCTC -> GTGCAACCTGATACGCTCT
GCGGCTTCGTAAATATGAA -> CGGCTTCGTAAATATGAAC
GACTCCTGAGGGGTATGGG -> ACTCCTGAGGGGTATGGGA
GACCTTCCCTATAACACTT -> ACCTTCCCTATAACACTTC
CGCCATACTCGTAAGCGGA -> GCCATACTCGTAAGCGGAG
CACGATACGGAGTAATGAC -> ACGATACGGAGTAATGACA
AAAATAAATTGACAAGAGC -> AAATAAATTGACAAGAGCA
CCATTACTACCTACTTCTA -> CATTACTACCTACTTCTAA
CCTGACCTTCCCTATAACA -> CTGACCTTCCCTATAACAC
AACTCGACGGGCCGTAATG -> ACTCGACGGGCCGTAATGT
CGTGTGCAATCTTCTCACT -> GTGTGCAATCTTCTCACTA
TAGATGAGGAATAGTCGTG -> AGATGAGGAATAGTCGTGT
CCCTGTCACAACCCTCGAT -> CCTGTCACAACCCTCGATA
CGGAATGTAGCATTCTAAT -> GGAATGTAGCATTCTAATA
ATTTAAGCGCACCCATTAC -> TTTAAGCGCACCCATTACT
CCGGATAAACGAGCTTTGA -> CGGATAAACGAGCTTTGAT
CTCGACGGGCCGTAATGTG -> TCGACGGGCCGTAATGTGT
ACGTTTGTTATCGGAGGTA -> CGTTTGTTATCGGAGGTAT
GGTATATTCTTTCAGCTCA -> GTATATTCTTTCAGCTCAG
TTCAGTAAAAATATCGAAT -> TCAGTAAAAATATCGAATG
AGACACAACTCCCTAGAAA -> GACACAACTCCCTAGAAAA
ATGATCATAAAGCAGTACT -> TGATCATAAAGCAGTACTA
CGGAGGTATATTCTTTCAT -> GGAGGTATATTCTTTCATG,GGAGGTATATTCTTTCATA
GTAGCAAACTCTGATCTAG -> TAGCAAACTCTGATCTAGA
CAGTCATTAGGATGCCACC -> AGTCATTAGGATGCCACCA
TTTGTTATCGGAGGTATAT -> TTGTTATCGGAGGTATATT
GTTAATTATGTTAATCGGC -> TTAATTATGTTAATCGGCG
ATGTGTTTCGGTGAGGTGA -> TGTGTTTCGGTGAGGTGAG
TGATACGCTCTGTAACTTT -> GATACGCTCTGTAACTTTA
GGATGCCACCACTTGTAAG -> GATGCCACCACTTGTAAGG
CCACCACCAGCTTTAAGCT -> CACCACCAGCTTTAAGCTC
ATCGTCTCAGTCATTAGGA -> TCGTCTCAGTCATTAGGAT
CCTGAGGAGTATAATTCCC -> CTGAGGAGTATAATTCCCT
TAAAAATAAATTGACAAGA -> AAAAATAAATTGACAAGAG
GACGCCATCGGAGGTATAT -> ACGCCATCGGAGGTATATT
TATAACCTTACTTGGTTTG -> ATAACCTTACTTGGTTTGA
GGCAGAGTCTATGTACTAG -> GCAGAGTCTATGTACTAGT
TCGTGATCCCCTGTCACAA -> CGTGATCCCCTGTCACAAC
AAACGTCAAAGCGACGACA -> AACGTCAAAGCGACGACAC
AGTGCCGATCGGAATGTAG -> GTGCCGATCGGAATGTAGC
ACTACCTATGGCGTACGGG -> CTACCTATGGCGTACGGGA
CTATGCAGGCCTAGGCAGA -> TATGCAGGCCTAGGCAGAG
AATGGAGCATAGCGCAACT -> ATGGAGCATAGCGCAACTG
ATACACTGTTTAACACAGA -> TACACTGTTTAACACAGAT
TGCCGAGCATCATAATTGC -> GCCGAGCATCATAATTGCC
ATCATATAACCCAAGCTCT -> TCATATAACCCAAGCTCTT
CGAGCAGAGACGCGTTTAT -> GAGCAGAGACGCGTTTATA
AATCTCCCTACGCAAGGTC -> ATCTCCCTACGCAAGGTCG
AAGTGCAGTGTACTGTCCT -> AGTGCAGTGTACTGTCCTA
CTACACACCGACACTAATT -> TACACACCGACACTAATTT
TGATCCCCTGTCACAACCC -> GATCCCCTGTCACAACCCT
GAGCTGCCTTGGATCGCAT -> AGCTGCCTTGGATCGCATC
GCAACCTGATACGCTCTGT -> CAACCTGATACGCTCTGTA
AGTACTAGCTATGCAGGCC -> GTACTAGCTATGCAGGCCT
CCCGCCTGACCTTCCCTAT -> CCGCCTGACCTTCCCTATA
ATCGGATTCCTAGTCCCCC -> TCGGATTCCTAGTCCCCCT
GCCATCGGAGGTATATTCT -> CCATCGGAGGTATATTCTT
ATAAAGGTTCTGAAATAGT -> TAAAGGTTCTGAAATAGTA
GCCCATCCATCGACTAATA -> CCCATCCATCGACTAATAG
TAAGCACGACAATCACTAT -> AAGCACGACAATCACTATA
AGGTCGCGCGGCTTCGTAA -> GGTCGCGCGGCTTCGTAAA
TTAAGAGCTTCATTACGGA -> TAAGAGCTTCATTACGGAG
CGGAGGCGTGAAGTTCTAT -> GGAGGCGTGAAGTTCTATT
CAAGGTCGCGCGGCTTCGT -> AAGGTCGCGCGGCTTCGTA
ATACGCTCTGTAACTTTAA -> TACGCTCTGTAACTTTAAT
AGCGACGACACGATACGGA -> GCGACGACACGATACGGAG
TGCGAAATTGAGGTTCGAG -> GCGAAATTGAGGTTCGAGC
TAATAGGGAGGACGAAATT -> AATAGGGAGGACGAAATTT
ATAACCTTACTTGGTTTGA -> TAACCTTACTTGGTTTGAA
TGATCATAAAGCAGTACTA -> GATCATAAAGCAGTACTAG
GATGCCACCACCAGCTTTA -> ATGCCACCACCAGCTTTAA
TCTCGACGCATAGACACAA -> CTCGACGCATAGACACAAC
CGGATATCGGCACATGTAC -> GGATATCGGCACATGTACA
ATCCACGATAAAATTCTCA -> TCCACGATAAAATTCTCAT
CCATAATATCAGTGTAAAT -> CATAATATCAGTGTAAATA
GGCGGTCGGAGGTATATTC -> GCGGTCGGAGGTATATTCT
CTAACATCAAATCTTGCCG -> TAACATCAAATCTTGCCGG
ACATCCCCGGATAAACGAG -> CATCCCCGGATAAACGAGC
CTGCGTGTGGATATGATTG -> TGCGTGTGGATATGATTGC
ATCGGCACATGTACACAGT -> TCGGCACATGTACACAGTT
CGTCCCTTATACGCAGATG -> GTCCCTTATACGCAGATGA
GTTAATCGGCGCCACTTCG -> TTAATCGGCGCCACTTCGT
TCGTTCATGATGCTCAATG -> CGTTCATGATGCTCAATGT
GATACGCTCTGTAACTTTA -> ATACGCTCTGTAACTTTAA
TCCTAGTCCCCCTATTCCG -> CCTAGTCCCCCTATTCCGC
GACACCCCTAGATGAGGAA -> ACACCCCTAGATGAGGAAT
ACGGATACCCGCCTGACCT -> CGGATACCCGCCTGACCTT
TAATAAGGATATAACCTTA -> AATAAGGATATAACCTTAC
GGTTCTGAAATAGTACAAC -> GTTCTGAAATAGTACAACC
TTAGGATGCCACCACCAGC -> TAGGATGCCACCACCAGCT
AAACGTCCTATACTACCGA -> AACGTCCTATACTACCGAT
ATGAACACCACGTCACGCT -> TGAACACCACGTCACGCTC
CTCTTAAAGGGCCTACAAC -> TCTTAAAGGGCCTACAACT
TTCGTAGTTGGATCTCGAC -> TCGTAGTTGGATCTCGACG
AGCATGTACATAAATACGG -> GCATGTACATAAATACGGA
CTGTATTTTATCATACGTT -> TGTATTTTATCATACGTTA
ATGTCGATGCCTGCGTGTG -> TGTCGATGCCTGCGTGTGG
ATCAGTGTAAATAAAGCTG -> TCAGTGTAAATAAAGCTGG
GTACTGTCCTACTATCCAC -> TACTGTCCTACTATCCACG
AAAGGTAGAATTGTAGACA -> AAGGTAGAATTGTAGACAT
ACGACACCCCTAGATGAGG -> CGACACCCCTAGATGAGGA
TAAACGAGCTTTGATTAAG -> AAACGAGCTTTGATTAAGA
AAGCACGACAATCACTATA -> AGCACGACAATCACTATAG
GCATAGCGCAACTGGAGGA -> CATAGCGCAACTGGAGGAC
GGATCAAAAGATCGTCTCA -> GATCAAAAGATCGTCTCAG
TCTTTCATGCGGCGGGTAT -> CTTTCATGCGGCGGGTATT
GTGAGCTGCCTTGGATCGC -> TGAGCTGCCTTGGATCGCA
TGGCCGTTGCACTCCCCGG -> GGCCGTTGCACTCCCCGGC
ATACGCAGATGATTAAACA -> TACGCAGATGATTAAACAC
GTCCTACTATCCACGATAA -> TCCTACTATCCACGATAAA
AAACCTAGTTAATTATGTT -> AACCTAGTTAATTATGTTA
TCCCTTGTCCGGATATCGG -> CCCTTGTCCGGATATCGGC
TTATCATACGTTAGCAGCA -> TATCATACGTTAGCAGCAT
TAAAATTCTCATTAGGATG -> AAAATTCTCATTAGGATGC
GCTTCCAGTCGAGCAGAGA -> CTTCCAGTCGAGCAGAGAC
GCGGGCGCAATCCATTATG -> CGGGCGCAATCCATTATGT
CTCCTGAGGGGTATGGGAA -> TCCTGAGGGGTATGGGAAT
TGGACACCGCAGTTATAAT -> GGACACCGCAGTTATAATA
TGTACTGTCCTACTATCCA -> GTACTGTCCTACTATCCAC
GATATAACCTTACTTGGTT -> ATATAACCTTACTTGGTTT
AGGATGCCACCACGACGTT -> GGATGCCACCACGACGTTT
TATGCATGAACACGAAGTG -> ATGCATGAACACGAAGTGC
TTGACAAGAGCACGGCAGA -> TGACAAGAGCACGGCAGAC
TATTATTTTCCAGATAGTC -> ATTATTTTCCAGATAGTCT
ATTAGGATGCCACCACTTG -> TTAGGATGCCACCACTTGT
GTGAGGTGAGCTGCCTTGG -> TGAGGTGAGCTGCCTTGGA
TTTCAGCTCAGGAGTGGAC -> TTCAGCTCAGGAGTGGACA
GTAATGACAGTCTACCTGC -> TAATGACAGTCTACCTGCG
ATAATAAGGATATAACCTT -> TAATAAGGATATAACCTTA
TAAAGCTAGGGTAGCAAAC -> AAAGCTAGGGTAGCAAACT
GTTCGAGCTAAGATTGGTT -> TTCGAGCTAAGATTGGTTC
CTTCGTGTCGGTGCATCAT -> TTCGTGTCGGTGCATCATA
CCATTATGTCTGTGAGCTT -> CATTATGTCTGTGAGCTTC
CGACGGGCCGTAATGTGTC -> GACGGGCCGTAATGTGTCA
TGGATCGCATCATTAGGAT -> GGATCGCATCATTAGGATG
TTAGTAAATGCCAGAATTT -> TAGTAAATGCCAGAATTTT
TGGCAACATCCCCGGATAA -> GGCAACATCCCCGGATAAA
GCTCGGAGGTATATTCTTT -> CTCGGAGGTATATTCTTTC
CACCAGCTTTAAGCTCGGA -> ACCAGCTTTAAGCTCGGAG
ACGTCGTGATCCCCTGTCA -> CGTCGTGATCCCCTGTCAC
GGAGACCACGTCGTGATCC -> GAGACCACGTCGTGATCCC
CCTGCGTAAAGGTAGAATT -> CTGCGTAAAGGTAGAATTG
ACTAATAGGGAGGACGAAA -> CTAATAGGGAGGACGAAAT
GGCGTACGGGAGTGTGCAT -> GCGTACGGGAGTGTGCATT
TTGGTTTGAACGCACTAAA -> TGGTTTGAACGCACTAAAT
TGAAGTTCTATTATTTTCC -> GAAGTTCTATTATTTTCCA
ACCACGTCGTGATCCCCTG -> CCACGTCGTGATCCCCTGT
CGACGCATAGACACAACTC -> GACGCATAGACACAACTCC
TGTAAATAAAGCTGGTCTT -> GTAAATAAAGCTGGTCTTG
TAGAGGTAAATGGAGCATA -> AGAGGTAAATGGAGCATAG
TATCGGAGGTATATTCTTT -> ATCGGAGGTATATTCTTTC
TTAAAGGGCCTACAACTCT -> TAAAGGGCCTACAACTCTC
CTGGTCTGCGGCAAAGCGT -> TGGTCTGCGGCAAAGCGTC
TCTATTATTTTCCAGATAG -> CTATTATTTTCCAGATAGT
CCTATGGCGTACGGGAGTG -> CTATGGCGTACGGGAGTGT
ACTAAATCTCCCTACGCAA -> CTAAATCTCCCTACGCAAG
TATGGGAATTGTCTACAAA -> ATGGGAATTGTCTACAAAC
ACCTCTCGATAAAGTATTA -> CCTCTCGATAAAGTATTAC
CAGTCGGGGCACCCCAAGC -> AGTCGGGGCACCCCAAGCA
ATGATTGCTAACATCAAAT -> TGATTGCTAACATCAAATC
TAGTCCCCCTATTCCGCCA -> AGTCCCCCTATTCCGCCAG
CCTGCTTTGCTTATGCCGC -> CTGCTTTGCTTATGCCGCC
CAGTACTAGCTATGCAGGC -> AGTACTAGCTATGCAGGCC
GTGTGGATATGATTGCTAA -> TGTGGATATGATTGCTAAC
CCTAGTCCCCCTATTCCGC -> CTAGTCCCCCTATTCCGCC
CACACCGACACTAATTTAA -> ACACCGACACTAATTTAAA
GCAGGCCTAGGCAGAGTCT -> CAGGCCTAGGCAGAGTCTA
ATAGACACAACTCCCTAGA -> TAGACACAACTCCCTAGAA
AAATTCTCATTAGGATGCC -> AATTCTCATTAGGATGCCA
TTCCAGGGATCCAATTACC -> TCCAGGGATCCAATTACCC
TCATTAGGATGCCACCACA -> CATTAGGATGCCACCACAT
CGCATAGACACAACTCCCT -> GCATAGACACAACTCCCTA
TTGTTATCGGAGGTATATT -> TGTTATCGGAGGTATATTC
ATGTCTGTGAGCTTCCAGT -> TGTCTGTGAGCTTCCAGTC
AGAGCACGGCAGACTCCTG -> GAGCACGGCAGACTCCTGA
TCAATAGAGGTAAATGGAG -> CAATAGAGGTAAATGGAGC
TGTATTTTATCATACGTTA -> GTATTTTATCATACGTTAG
AGTTGGATCTCGACGCATA -> GTTGGATCTCGACGCATAG
GACTACCTATGGCGTACGG -> ACTACCTATGGCGTACGGG
TCTATGTACTAGTGTAAAA -> CTATGTACTAGTGTAAAAA
AGGTATATTCTTTCAGCTC -> GGTATATTCTTTCAGCTCA
TACAACTCTCCCTTGTCCG -> ACAACTCTCCCTTGTCCGG
GATCTAGATGATCATAAAG -> ATCTAGATGATCATAAAGC
CTAGGGACGGTTAGTGCCG -> TAGGGACGGTTAGTGCCGA
CCCTAGAATAATAAGGATA -> CCTAGAATAATAAGGATAT
CCTTTATGGCCAATACCCG -> CTTTATGGCCAATACCCGG
TCTGATCTAGATGATCATA -> CTGATCTAGATGATCATAA
AGCATAGCGCAACTGGAGG -> GCATAGCGCAACTGGAGGA
CAGAAGAACAGTTGACAAA -> AGAAGAACAGTTGACAAAC
GACATAGCCAATACACTGT -> ACATAGCCAATACACTGTT
CGCAATCCATTATGTCTGT -> GCAATCCATTATGTCTGTG
TTCCGCCAGAAGAACAGTT -> TCCGCCAGAAGAACAGTTG
TTACCACCTCTCGATAAAG -> TACCACCTCTCGATAAAGT
AAAGGGTCCCTGAGGAGTA -> AAGGGTCCCTGAGGAGTAT
ACCGCAGTTATAATATGTC -> CCGCAGTTATAATATGTCG
TACTTGGTTTGAACGCACT -> ACTTGGTTTGAACGCACTA
ATTCCCTCGTCCCTTATAC -> TTCCCTCGTCCCTTATACG
GATGGCCGTTGCACTCCCC -> ATGGCCGTTGCACTCCCCG
GACTAATAGGGAGGACGAA -> ACTAATAGGGAGGACGAAA
TTCTACTGGCGCCTGGTCT -> TCTACTGGCGCCTGGTCTG
AAGCAAGTGCAGTGTACTG -> AGCAAGTGCAGTGTACTGT
TTATACGCAGATGATTAAA -> TATACGCAGATGATTAAAC
ACAAGAGCACGGCAGACTC -> CAAGAGCACGGCAGACTCC
TAAAGCTGGTCTTGCGCAA -> AAAGCTGGTCTTGCGCAAC
TAGTCGTGTCCCAGTCGGG -> AGTCGTGTCCCAGTCGGGG
CCCAGTCGGGGCACCCCAA -> CCAGTCGGGGCACCCCAAG
GGCGCCACTTCGTGTCGGT -> GCGCCACTTCGTGTCGGTG
CCGAGCATCATAATTGCCG -> CGAGCATCATAATTGCCGT
GAGCACGGCAGACTCCTGA -> AGCACGGCAGACTCCTGAG
ATAAGGATATAACCTTACT -> TAAGGATATAACCTTACTT
TTGAACGCACTAAATCTCC -> TGAACGCACTAAATCTCCC
TCCTATACTACCGATCGGA -> CCTATACTACCGATCGGAT
TGATGTACCCCCAAAGGGT -> GATGTACCCCCAAAGGGTC
AAGATTGGTTCCAGGGATC -> AGATTGGTTCCAGGGATCC
CCACCACGACGTTTGTTAT -> CACCACGACGTTTGTTATC
TGCTTATGCCGCCATACTC -> GCTTATGCCGCCATACTCG
CCAGAATTTTTCGTAGTTG -> CAGAATTTTTCGTAGTTGG
ATCCAATTACCCCGAAAGA -> TCCAATTACCCCGAAAGAC
CACTAATTTAAAAATAAAT -> ACTAATTTAAAAATAAATT
CTCATTAGGATGCCACCAC -> TCATTAGGATGCCACCACC
CGTGAAGTTCTATTATTTT -> GTGAAGTTCTATTATTTTC
TTAGGATGCCACCACTTGT -> TAGGATGCCACCACTTGTA
ATCCATTATGTCTGTGAGC -> TCCATTATGTCTGTGAGCT
GACCGCGGACAACAGGTCA -> ACCGCGGACAACAGGTCAT
TCGTGTCCCAGTCGGGGCA -> CGTGTCCCAGTCGGGGCAC
CTTGGTTTGAACGCACTAA -> TTGGTTTGAACGCACTAAA
CACCCCTAGATGAGGAATA -> ACCCCTAGATGAGGAATAG
ACACCGGGTTATGTCGATG -> CACCGGGTTATGTCGATGC
GCCGTCGCTGGCAACATCC -> CCGTCGCTGGCAACATCCC
CAGCCTGTTACCACCTCTC -> AGCCTGTTACCACCTCTCG
CTACCTATGGCGTACGGGA -> TACCTATGGCGTACGGGAG
GATAGTCTCATGTGTTTCG -> ATAGTCTCATGTGTTTCGG
GGCAAAGCGTCCACTCCGC -> GCAAAGCGTCCACTCCGCG
CACCCGGCTGTGGTCCATA -> ACCCGGCTGTGGTCCATAA
CATCAAATCTTGCCGGCCC -> ATCAAATCTTGCCGGCCCA
GCCAATACCCGGACGGATA -> CCAATACCCGGACGGATAC
CCCGGCTGTGGTCCATAAT -> CCGGCTGTGGTCCATAATA
CAAAAGATCGTCTCAGTCA -> AAAAGATCGTCTCAGTCAT
TCACGCTCACCCGGCTGTG -> CACGCTCACCCGGCTGTGG
TGAACACGAAGTGCCGAGC -> GAACACGAAGTGCCGAGCA
GAAGTTCTATTATTTTCCA -> AAGTTCTATTATTTTCCAG
GTCCTATACTACCGATCGG -> TCCTATACTACCGATCGGA
CCCCTAGATGAGGAATAGT -> CCCTAGATGAGGAATAGTC
AGCCTTTATGGCCAATACC -> GCCTTTATGGCCAATACCC
CAATTATATCTGTCCTTGA -> AATTATATCTGTCCTTGAA
GTCGATGCCTGCGTGTGGA -> TCGATGCCTGCGTGTGGAT
CTGTTACCACCTCTCGATA -> TGTTACCACCTCTCGATAA
TTTACACGACACCCCTAGA -> TTACACGACACCCCTAGAT
CGCACTAAATCTCCCTACG -> GCACTAAATCTCCCTACGC
ATAATATGTCGTGTAAGTG -> TAATATGTCGTGTAAGTGC
ATTTATAAGCACGACAATC -> TTTATAAGCACGACAATCA
GTCGGTGCATCATATAACC -> TCGGTGCATCATATAACCC
AAGGCGGTCGGAGGTATAT -> AGGCGGTCGGAGGTATATT
CTGAGGAGTATAATTCCCT -> TGAGGAGTATAATTCCCTC
GGAGTGGACAAAGATTTAA -> GAGTGGACAAAGATTTAAG
ACCACATGTGACGCCATCG -> CCACATGTGACGCCATCGG
GAATAAAACTCTTAAAGGG -> AATAAAACTCTTAAAGGGC
ACCTTCCCTATAACACTTC -> CCTTCCCTATAACACTTCA
AGTCGAGCAGAGACGCGTT -> GTCGAGCAGAGACGCGTTT
GTATATTCTTTCAGCTCAG -> TATATTCTTTCAGCTCAGG
CCGGATATCGGCACATGTA -> CGGATATCGGCACATGTAC
ATCTCCCTACGCAAGGTCG -> TCTCCCTACGCAAGGTCGC
TATAACGCAATTATATCTG -> ATAACGCAATTATATCTGT
TAAAGGGCCTACAACTCTC -> AAAGGGCCTACAACTCTCC
CTGTCCTTGAATCAATAGA -> TGTCCTTGAATCAATAGAG
CGCGGACAACAGGTCATGC -> GCGGACAACAGGTCATGCG
ATTCTTTCATGCGGCGGGT -> TTCTTTCATGCGGCGGGTA
TACCACCTCTCGATAAAGT -> ACCACCTCTCGATAAAGTA
TATGTCTGTGAGCTTCCAG -> ATGTCTGTGAGCTTCCAGT
CCTGTCACAACCCTCGATA -> CTGTCACAACCCTCGATAC
ACCGGGTTATGTCGATGCC -> CCGGGTTATGTCGATGCCT
TTTAAGCTCGGAGGTATAT -> TTAAGCTCGGAGGTATATT
ACCGACACTAATTTAAAAA -> CCGACACTAATTTAAAAAT
AATACGGATGATTTACACG -> ATACGGATGATTTACACGA
GGAGTGTGCATTTATAAGC -> GAGTGTGCATTTATAAGCA
CACCTCTCGATAAAGTATT -> ACCTCTCGATAAAGTATTA
GAGGTGAGCTGCCTTGGAT -> AGGTGAGCTGCCTTGGATC
CTGTCCTACTATCCACGAT -> TGTCCTACTATCCACGATA
GCCACCACTTGTAAGGCGG -> CCACCACTTGTAAGGCGGT
GACCGGATCAAAAGATCGT -> ACCGGATCAAAAGATCGTC
CCCATCCATCGACTAATAG -> CCATCCATCGACTAATAGG
GGATGCCACCACGACGTTT -> GATGCCACCACGACGTTTG
ACGCCCTAGAATAATAAGG -> CGCCCTAGAATAATAAGGA
CAGTCGAGCAGAGACGCGT -> AGTCGAGCAGAGACGCGTT
AGTTTACGCCCTAGAATAA -> GTTTACGCCCTAGAATAAT
GGACAAAGATTTAAGCGCA -> GACAAAGATTTAAGCGCAC
ACTCTCCCTTGTCCGGATA -> CTCTCCCTTGTCCGGATAT
ATGGCGTACGGGAGTGTGC -> TGGCGTACGGGAGTGTGCA
AGGAGTATAATTCCCTCGT -> GGAGTATAATTCCCTCGTC
GTACAACCAGAATAAAACT -> TACAACCAGAATAAAACTC
CGCATCATTAGGATGCCAC -> GCATCATTAGGATGCCACC
ATAGAGGTAAATGGAGCAT -> TAGAGGTAAATGGAGCATA
CACTTCATTAGGATGCCAC -> ACTTCATTAGGATGCCACC
TAGGCAGAGTCTATGTACT -> AGGCAGAGTCTATGTACTA
GGCCTACAACTCTCCCTTG -> GCCTACAACTCTCCCTTGT
ACGCTCACCCGGCTGTGGT -> CGCTCACCCGGCTGTGGTC
TAAAAATATCGAATGTTAG -> AAAAATATCGAATGTTAGT
AAATAAAGCTGGTCTTGCG -> AATAAAGCTGGTCTTGCGC
GGCTGTGGTCCATAATATC -> GCTGTGGTCCATAATATCA
GACCGTTGTAATGATGTAC -> ACCGTTGTAATGATGTACC
GTTTACGCCCTAGAATAAT -> TTTACGCCCTAGAATAATA
GAGGCGTGAAGTTCTATTA -> AGGCGTGAAGTTCTATTAT
AAGACCGGATCAAAAGATC -> AGACCGGATCAAAAGATCG
AGAATAAAACTCTTAAAGG -> GAATAAAACTCTTAAAGGG
CCGGGTTATGTCGATGCCT -> CGGGTTATGTCGATGCCTG
ATATTCTTTCAGTAAAAAT -> TATTCTTTCAGTAAAAATA
TCCCTATAACACTTCATTA -> CCCTATAACACTTCATTAG
CGATCGGATTCCTAGTCCC -> GATCGGATTCCTAGTCCCC
CATTATGTCTGTGAGCTTC -> ATTATGTCTGTGAGCTTCC
TTCCCTCGTCCCTTATACG -> TCCCTCGTCCCTTATACGC
TCTTTCAGTAAAAATATCG -> CTTTCAGTAAAAATATCGA
TTAAAAATAAATTGACAAG -> TAAAAATAAATTGACAAGA
AATAAGGATATAACCTTAC -> ATAAGGATATAACCTTACT
TGAGCTGCCTTGGATCGCA -> GAGCTGCCTTGGATCGCAT
CGACGTTTGTTATCGGAGG -> GACGTTTGTTATCGGAGGT
TCACTATAGATATGCATGA -> CACTATAGATATGCATGAA
TGGTTCCAGGGATCCAATT -> GGTTCCAGGGATCCAATTA
AAAAAGAGTTTACGCCCTA -> AAAAGAGTTTACGCCCTAG
AAATCTTGCCGGCCCATCC -> AATCTTGCCGGCCCATCCA
ATATAACCCAAGCTCTTCG -> TATAACCCAAGCTCTTCGT
GCCTAGGCAGAGTCTATGT -> CCTAGGCAGAGTCTATGTA
GTAATGATGTACCCCCAAA -> TAATGATGTACCCCCAAAG
TCCGCGTGCAACCTGATAC -> CCGCGTGCAACCTGATACG
GCTAAGATTGGTTCCAGGG -> CTAAGATTGGTTCCAGGGA
TCTAAATCGCGGGCAGAAG -> CTAAATCGCGGGCAGAAGA
GTTTGTTATCGGAGGTATA -> TTTGTTATCGGAGGTATAT
TCCCTACGCAAGGTCGCGC -> CCCTACGCAAGGTCGCGCG
GGATCGCATCATTAGGATG -> GATCGCATCATTAGGATGC
GTTATAATATGTCGTGTAA -> TTATAATATGTCGTGTAAG
TAATCGGCGCCACTTCGTG -> AATCGGCGCCACTTCGTGT
CGGCAGACTCCTGAGGGGT -> GGCAGACTCCTGAGGGGTA
CCGCAGTTATAATATGTCG -> CGCAGTTATAATATGTCGT
TTCAGCTCAGGAGTGGACA -> TCAGCTCAGGAGTGGACAA
GATTAAACACCGGGTTATG -> ATTAAACACCGGGTTATGT
TGGAGGACCGCGGACAACA -> GGAGGACCGCGGACAACAG
CAGATAGTCTCATGTGTTT -> AGATAGTCTCATGTGTTTC
CAAACTCTGATCTAGATGA -> AAACTCTGATCTAGATGAT
TGTACTAGTGTAAAAATCT -> GTACTAGTGTAAAAATCTG
CTCTTCGTAAGCCTTTATG -> TCTTCGTAAGCCTTTATGG
ACACTTCATTAGGATGCCA -> CACTTCATTAGGATGCCAC
CGTTGTAATGATGTACCCC -> GTTGTAATGATGTACCCCC
AGGGACGGTTAGTGCCGAT -> GGGACGGTTAGTGCCGATC
GTATATTCTTTCATATGGC -> TATATTCTTTCATATGGCG
ATGCCACCACCAGCTTTAA -> TGCCACCACCAGCTTTAAG
CACCACTTGTAAGGCGGTC -> ACCACTTGTAAGGCGGTCG
CGTCTCAGTCATTAGGATG -> GTCTCAGTCATTAGGATGC
TCATGCGAAATTGAGGTTC -> CATGCGAAATTGAGGTTCG
CGGGCCGTAATGTGTCATG -> GGGCCGTAATGTGTCATGA
GACACAACTCCCTAGAAAA -> ACACAACTCCCTAGAAAAA
TGAACTGGTTCTACTGGCG -> GAACTGGTTCTACTGGCGC
CCCTTATACGCAGATGATT -> CCTTATACGCAGATGATTA
TCGCGCGGCTTCGTAAATA -> CGCGCGGCTTCGTAAATAT
AGCAGTACTAGCTATGCAG -> GCAGTACTAGCTATGCAGG
ACAAACAAGCTCTAGGGAC -> CAAACAAGCTCTAGGGACG
CTATGTACTAGTGTAAAAA -> TATGTACTAGTGTAAAAAT
ACCTAGTTAATTATGTTAA -> CCTAGTTAATTATGTTAAT
TGCAAACGTCAAAGCGACG -> GCAAACGTCAAAGCGACGA
TAAGCTCGGAGGTATATTC -> AAGCTCGGAGGTATATTCT
GTGCCGATCGGAATGTAGC -> TGCCGATCGGAATGTAGCA
TGCCACCACGACGTTTGTT -> GCCACCACGACGTTTGTTA
GCTGTGGTCCATAATATCA -> CTGTGGTCCATAATATCAG
TGCTTTGCTTATGCCGCCA -> GCTTTGCTTATGCCGCCAT
CTCCGCGTGCAACCTGATA -> TCCGCGTGCAACCTGATAC
CTAGGCAGAGTCTATGTAC -> TAGGCAGAGTCTATGTACT
AGTGTAAATAAAGCTGGTC -> GTGTAAATAAAGCTGGTCT
GCCATACTCGTAAGCGGAG -> CCATACTCGTAAGCGGAGA
CAGTGTAAATAAAGCTGGT -> AGTGTAAATAAAGCTGGTC
CTGGTTCTACTGGCGCCTG -> TGGTTCTACTGGCGCCTGG
CAGAAGACCGGATCAAAAG -> AGAAGACCGGATCAAAAGA
AGACGCGTTTATAGGTCGT -> GACGCGTTTATAGGTCGTT
GGTCTGCGGCAAAGCGTCC -> GTCTGCGGCAAAGCGTCCA
CAGATCAGACCGTTGTAAT -> AGATCAGACCGTTGTAATG
GTGTCGGTGCATCATATAA -> TGTCGGTGCATCATATAAC
TATATTCTTTCATATGGCG -> ATATTCTTTCATATGGCGG
AGGCGTGAAGTTCTATTAT -> GGCGTGAAGTTCTATTATT
GTATAACGCAATTATATCT -> TATAACGCAATTATATCTG
CGTGTCGGTGCATCATATA -> GTGTCGGTGCATCATATAA
TAACTTTAATTTGGACACC -> AACTTTAATTTGGACACCG
ACCAGCTTTAAGCTCGGAG -> CCAGCTTTAAGCTCGGAGG
AGGAATAGTCGTGTCCCAG -> GGAATAGTCGTGTCCCAGT
TGGTCTGCGGCAAAGCGTC -> GGTCTGCGGCAAAGCGTCC
CTCTCCCTTGTCCGGATAT -> TCTCCCTTGTCCGGATATC
GGGTATTTAGATGGCCGTT -> GGTATTTAGATGGCCGTTG
CTAGTTAATTATGTTAATC -> TAGTTAATTATGTTAATCG
AGCAGAGACGCGTTTATAG -> GCAGAGACGCGTTTATAGG
CAAACCTAGTTAATTATGT -> AAACCTAGTTAATTATGTT
TTTTTCGTAGTTGGATCTC -> TTTTCGTAGTTGGATCTCG
GGGAATTGTCTACAAACCT -> GGAATTGTCTACAAACCTA
CTCAATGTGGAGTATAACG -> TCAATGTGGAGTATAACGC
CCAAAGGGTCCCTGAGGAG -> CAAAGGGTCCCTGAGGAGT
CTTAAAGGGCCTACAACTC -> TTAAAGGGCCTACAACTCT
GGACAACAGGTCATGCGAA -> GACAACAGGTCATGCGAAA
CTCTCGATAAAGTATTACG -> TCTCGATAAAGTATTACGA
CCAGGGATCCAATTACCCC -> CAGGGATCCAATTACCCCG
TCCTTGAATCAATAGAGGT -> CCTTGAATCAATAGAGGTA
GCAATTATATCTGTCCTTG -> CAATTATATCTGTCCTTGA
GCTGGCAACATCCCCGGAT -> CTGGCAACATCCCCGGATA
GCAGTTATAATATGTCGTG -> CAGTTATAATATGTCGTGT
GCCTTGGATCGCATCATTA -> CCTTGGATCGCATCATTAG
CACCACGACGTTTGTTATC -> ACCACGACGTTTGTTATCG
AGATAGTCTCATGTGTTTC -> GATAGTCTCATGTGTTTCG
GGAGTAATGACAGTCTACC -> GAGTAATGACAGTCTACCT
ACGATAAAATTCTCATTAG -> CGATAAAATTCTCATTAGG
TTCATGATGCTCAATGTGG -> TCATGATGCTCAATGTGGA
ACGCAATTATATCTGTCCT -> CGCAATTATATCTGTCCTT
AATGTGGAGTATAACGCAA -> ATGTGGAGTATAACGCAAT
TAGCCAATACACTGTTTAA -> AGCCAATACACTGTTTAAC
CGCCACTTCGTGTCGGTGC -> GCCACTTCGTGTCGGTGCA
CACGAAGTGCCGAGCATCA -> ACGAAGTGCCGAGCATCAT
TGCGGCGGGTATTTAGATG -> GCGGCGGGTATTTAGATGG
CGCGTTTATAGGTCGTTCA -> GCGTTTATAGGTCGTTCAT
ATGCAGGCCTAGGCAGAGT -> TGCAGGCCTAGGCAGAGTC
CAGTAAAAATATCGAATGT -> AGTAAAAATATCGAATGTT
GCTCACCCGGCTGTGGTCC -> CTCACCCGGCTGTGGTCCA
AGAACAGTTGACAAACAAG -> GAACAGTTGACAAACAAGC
CTATAAAGGTTCTGAAATA -> TATAAAGGTTCTGAAATAG
TATCCACGATAAAATTCTC -> ATCCACGATAAAATTCTCA
CGTTGCACTCCCCGGCCAT -> GTTGCACTCCCCGGCCATC
AAGGTTCTGAAATAGTACA -> AGGTTCTGAAATAGTACAA
AAATCGCGGGCAGAAGACC -> AATCGCGGGCAGAAGACCG
ATGATTAAACACCGGGTTA -> TGATTAAACACCGGGTTAT
ATTATGTCTGTGAGCTTCC -> TTATGTCTGTGAGCTTCCA
TTATAATATGTCGTGTAAG -> TATAATATGTCGTGTAAGT
CGACGACACGATACGGAGT -> GACGACACGATACGGAGTA
AGCGCAACTGGAGGACCGC -> GCGCAACTGGAGGACCGCG
GGTGAGGTGAGCTGCCTTG -> GTGAGGTGAGCTGCCTTGG
GGAGGTATATTCTTTCATG -> GAGGTATATTCTTTCATGC
CTGATACGCTCTGTAACTT -> TGATACGCTCTGTAACTTT
TCTGTGAGCTTCCAGTCGA -> CTGTGAGCTTCCAGTCGAG
TAGCAGCATGTACATAAAT -> AGCAGCATGTACATAAATA
TGATGCTCAATGTGGAGTA -> GATGCTCAATGTGGAGTAT
GGCGCAATCCATTATGTCT -> GCGCAATCCATTATGTCTG
TGTACACAGTTCTGGGCCG -> GTACACAGTTCTGGGCCGC
CCGACACTAATTTAAAAAT -> CGACACTAATTTAAAAATA
TCGGTGCATCATATAACCC -> CGGTGCATCATATAACCCA
ATGATTTACACGACACCCC -> TGATTTACACGACACCCCT
AGACATAGCCAATACACTG -> GACATAGCCAATACACTGT
CCCCAAAGGGTCCCTGAGG -> CCCAAAGGGTCCCTGAGGA
TGCTAACATCAAATCTTGC -> GCTAACATCAAATCTTGCC
AGCTAGGGTAGCAAACTCT -> GCTAGGGTAGCAAACTCTG
TACGCAGATGATTAAACAC -> ACGCAGATGATTAAACACC
AAATTCCTGCTTTGCTTAT -> AATTCCTGCTTTGCTTATG
AAGCGACGACACGATACGG -> AGCGACGACACGATACGGA
ATGGCCAATACCCGGACGG -> TGGCCAATACCCGGACGGA
GTGAGCCCTTAGACTACCT -> TGAGCCCTTAGACTACCTA
ATTCTTTCAGTAAAAATAT -> TTCTTTCAGTAAAAATATC
AACCCTCGATACCGTGTGC -> ACCCTCGATACCGTGTGCA
GAAATTTAAATTCCTGCTT -> AAATTTAAATTCCTGCTTT
ATCTGTCCTTGAATCAATA -> TCTGTCCTTGAATCAATAG
CTTGCCGGCCCATCCATCG -> TTGCCGGCCCATCCATCGA
CTACAAACCTAGTTAATTA -> TACAAACCTAGTTAATTAT
CATATGGCGGTATGACTAG -> ATATGGCGGTATGACTAGG
GTGGACAAAGATTTAAGCG -> TGGACAAAGATTTAAGCGC
GGGCCTACAACTCTCCCTT -> GGCCTACAACTCTCCCTTG
GTCGCTGGCAACATCCCCG -> TCGCTGGCAACATCCCCGG
CATGATGCTCAATGTGGAG -> ATGATGCTCAATGTGGAGT
AGGCGGTCGGAGGTATATT -> GGCGGTCGGAGGTATATTC
TAATTCCCTCGTCCCTTAT -> AATTCCCTCGTCCCTTATA
CTTACTTGGTTTGAACGCA -> TTACTTGGTTTGAACGCAC
TTATTTTCCAGATAGTCTC -> TATTTTCCAGATAGTCTCA
CACGACAATCACTATAGAT -> ACGACAATCACTATAGATA
AACGTCAAAGCGACGACAC -> ACGTCAAAGCGACGACACG
CATAGCCAATACACTGTTT -> ATAGCCAATACACTGTTTA
AATATCGAATGTTAGTAAA -> ATATCGAATGTTAGTAAAT
ACCCCAAGCAAGTGCAGTG -> CCCCAAGCAAGTGCAGTGT
GGTTCTACTGGCGCCTGGT -> GTTCTACTGGCGCCTGGTC
GGTCTTGCGCAACTACACA -> GTCTTGCGCAACTACACAC
CCTAGTTAATTATGTTAAT -> CTAGTTAATTATGTTAATC
ACCGCGGACAACAGGTCAT -> CCGCGGACAACAGGTCATG
CAATCACTATAGATATGCA -> AATCACTATAGATATGCAT
GGACACCGCAGTTATAATA -> GACACCGCAGTTATAATAT
CAGGCCTAGGCAGAGTCTA -> AGGCCTAGGCAGAGTCTAT
AATCGCGGGCAGAAGACCG -> ATCGCGGGCAGAAGACCGG
ACGGATGATTTACACGACA -> CGGATGATTTACACGACAC
CCTTGAATCAATAGAGGTA -> CTTGAATCAATAGAGGTAA
TCATATGGCGGTATGACTA -> CATATGGCGGTATGACTAG
GTGTACTGTCCTACTATCC -> TGTACTGTCCTACTATCCA
TAAATGCCAGAATTTTTCG -> AAATGCCAGAATTTTTCGT
GGTCATGCGAAATTGAGGT -> GTCATGCGAAATTGAGGTT
CCACGACGTTTGTTATCGG -> CACGACGTTTGTTATCGGA
AATTACCCCGAAAGACTCC -> ATTACCCCGAAAGACTCCA
CTTTAAGCTCGGAGGTATA -> TTTAAGCTCGGAGGTATAT
CATTTATAAGCACGACAAT -> ATTTATAAGCACGACAATC
TAAGCCTTTATGGCCAATA -> AAGCCTTTATGGCCAATAC
CTAGATGAGGAATAGTCGT -> TAGATGAGGAATAGTCGTG
AGGCCTAGGCAGAGTCTAT -> GGCCTAGGCAGAGTCTATG
TGCAATCTTCTCACTAAAC -> GCAATCTTCTCACTAAACG
TGACTAGGCGGGCGCAATC -> GACTAGGCGGGCGCAATCC
GTAAAGGTAGAATTGTAGA -> TAAAGGTAGAATTGTAGAC
GTCCATAATATCAGTGTAA -> TCCATAATATCAGTGTAAA
AGTGTACTGTCCTACTATC -> GTGTACTGTCCTACTATCC
GATCTCGACGCATAGACAC -> ATCTCGACGCATAGACACA
CACCGGGTTATGTCGATGC -> ACCGGGTTATGTCGATGCC
GAGTGTGCATTTATAAGCA -> AGTGTGCATTTATAAGCAC
ATGCCAGAATTTTTCGTAG -> TGCCAGAATTTTTCGTAGT
AATCTTCTCACTAAACGTC -> ATCTTCTCACTAAACGTCC
TTATGCCGCCATACTCGTA -> TATGCCGCCATACTCGTAA
ATTACGGAGGCGTGAAGTT -> TTACGGAGGCGTGAAGTTC
GAGACGCGTTTATAGGTCG -> AGACGCGTTTATAGGTCGT
AACCTGATACGCTCTGTAA -> ACCTGATACGCTCTGTAAC
TAAGCGCACCCATTACTAC -> AAGCGCACCCATTACTACC
TCTCGATAAAGTATTACGA -> CTCGATAAAGTATTACGAG
CTGTTTAACACAGATCAGA -> TGTTTAACACAGATCAGAC
GTTTATAGGTCGTTCATGA -> TTTATAGGTCGTTCATGAT
TGGCCAATACCCGGACGGA -> GGCCAATACCCGGACGGAT
ACACGAAGTGCCGAGCATC -> CACGAAGTGCCGAGCATCA
ATGCCACCACGACGTTTGT -> TGCCACCACGACGTTTGTT
ACTCGACGGGCCGTAATGT -> CTCGACGGGCCGTAATGTG
AATTTTTCGTAGTTGGATC -> ATTTTTCGTAGTTGGATCT
AAGCTAGGGTAGCAAACTC -> AGCTAGGGTAGCAAACTCT
CACGACACCCCTAGATGAG -> ACGACACCCCTAGATGAGG
AATAGAGGTAAATGGAGCA -> ATAGAGGTAAATGGAGCAT
ACAACCCTCGATACCGTGT -> CAACCCTCGATACCGTGTG
AGCCTGTTACCACCTCTCG -> GCCTGTTACCACCTCTCGA
AGCACGACAATCACTATAG -> GCACGACAATCACTATAGA
GTGGAGTATAACGCAATTA -> TGGAGTATAACGCAATTAT
ACCCGGCTGTGGTCCATAA -> CCCGGCTGTGGTCCATAAT
ATTTAAAAATAAATTGACA -> TTTAAAAATAAATTGACAA
AGTATAATTCCCTCGTCCC -> GTATAATTCCCTCGTCCCT
GTGCAAACGTCAAAGCGAC -> TGCAAACGTCAAAGCGACG
ACATCAAATCTTGCCGGCC -> CATCAAATCTTGCCGGCCC
TTACGCCCTAGAATAATAA -> TACGCCCTAGAATAATAAG
AGGCAGAGTCTATGTACTA -> GGCAGAGTCTATGTACTAG
CTATACTACCGATCGGATT -> TATACTACCGATCGGATTC
GAATTTTTCGTAGTTGGAT -> AATTTTTCGTAGTTGGATC
CGCAAGGTCGCGCGGCTTC -> GCAAGGTCGCGCGGCTTCG
TGCCGGCCCATCCATCGAC -> GCCGGCCCATCCATCGACT
TGTAAGTGCAAACGTCAAA -> GTAAGTGCAAACGTCAAAG
AGTACAACCAGAATAAAAC -> GTACAACCAGAATAAAACT
TGCCGCCATACTCGTAAGC -> GCCGCCATACTCGTAAGCG
TTATAGGTCGTTCATGATG -> TATAGGTCGTTCATGATGC
ACACAGATCAGACCGTTGT -> CACAGATCAGACCGTTGTA
CACGTCACGCTCACCCGGC -> ACGTCACGCTCACCCGGCT
AAGCAGTACTAGCTATGCA -> AGCAGTACTAGCTATGCAG
AATAAAACTCTTAAAGGGC -> ATAAAACTCTTAAAGGGCC
GATCCAATTACCCCGAAAG -> ATCCAATTACCCCGAAAGA
TTACGAGCCTATAAAGGTT -> TACGAGCCTATAAAGGTTC
AATAAAGCTGGTCTTGCGC -> ATAAAGCTGGTCTTGCGCA
CGAGCTAAGATTGGTTCCA -> GAGCTAAGATTGGTTCCAG
TAGACTACCTATGGCGTAC -> AGACTACCTATGGCGTACG
CCACCTCTCGATAAAGTAT -> CACCTCTCGATAAAGTATT
TTGGACACCGCAGTTATAA -> TGGACACCGCAGTTATAAT
TCATATAACCCAAGCTCTT -> CATATAACCCAAGCTCTTC
GTATATTCTTTCAGTAAAA -> TATATTCTTTCAGTAAAAA
GGAATTGTCTACAAACCTA -> GAATTGTCTACAAACCTAG
ATACCGTGTGCAATCTTCT -> TACCGTGTGCAATCTTCTC
AAAAATCTGTATTTTATCA -> AAAATCTGTATTTTATCAT
ACACTGTTTAACACAGATC -> CACTGTTTAACACAGATCA
GAATGTAGCATTCTAATAA -> AATGTAGCATTCTAATAAA
TTAGATGGCCGTTGCACTC -> TAGATGGCCGTTGCACTCC
CCGGACGGATACCCGCCTG -> CGGACGGATACCCGCCTGA
TCGACGCATAGACACAACT -> CGACGCATAGACACAACTC
AAGAACAGTTGACAAACAA -> AGAACAGTTGACAAACAAG
GCAACTACACACCGACACT -> CAACTACACACCGACACTA
CAACTCTCCCTTGTCCGGA -> AACTCTCCCTTGTCCGGAT
CGTAAAGGTAGAATTGTAG -> GTAAAGGTAGAATTGTAGA
TCGACTAATAGGGAGGACG -> CGACTAATAGGGAGGACGA
CAGCTTTAAGCTCGGAGGT -> AGCTTTAAGCTCGGAGGTA
TAAATAAAGCTGGTCTTGC -> AAATAAAGCTGGTCTTGCG
GCTTTGCTTATGCCGCCAT -> CTTTGCTTATGCCGCCATA
ATAGATATGCATGAACACG -> TAGATATGCATGAACACGA
ACCACCTCTCGATAAAGTA -> CCACCTCTCGATAAAGTAT
CAGTTATAATATGTCGTGT -> AGTTATAATATGTCGTGTA
TGCCTTGGATCGCATCATT -> GCCTTGGATCGCATCATTA
TTAAACACCGGGTTATGTC -> TAAACACCGGGTTATGTCG
TAGAAAAAAGAGTTTACGC -> AGAAAAAAGAGTTTACGCC
GATATCGGCACATGTACAC -> ATATCGGCACATGTACACA
ATAAAGCTGGTCTTGCGCA -> TAAAGCTGGTCTTGCGCAA
ATCTCGACGCATAGACACA -> TCTCGACGCATAGACACAA
TGACGCCATCGGAGGTATA -> GACGCCATCGGAGGTATAT
AGATGATTAAACACCGGGT -> GATGATTAAACACCGGGTT
TTTCCAGATAGTCTCATGT -> TTCCAGATAGTCTCATGTG
TCATGCGGCGGGTATTTAG -> CATGCGGCGGGTATTTAGA
TGTCGTGTAAGTGCAAACG -> GTCGTGTAAGTGCAAACGT
CCAATACACTGTTTAACAC -> CAATACACTGTTTAACACA
TAGGTCGTTCATGATGCTC -> AGGTCGTTCATGATGCTCA
GGCACATGTACACAGTTCT -> GCACATGTACACAGTTCTG
ATGTAGCATTCTAATAAAG -> TGTAGCATTCTAATAAAGC
GCCGGCCCATCCATCGACT -> CCGGCCCATCCATCGACTA
TTTGAACGCACTAAATCTC -> TTGAACGCACTAAATCTCC
GCGGGCAGAAGACCGGATC -> CGGGCAGAAGACCGGATCA
CCCGGACGGATACCCGCCT -> CCGGACGGATACCCGCCTG
AGACCACGTCGTGATCCCC -> GACCACGTCGTGATCCCCT
GCTCAGGAGTGGACAAAGA -> CTCAGGAGTGGACAAAGAT
CAGGAGTGGACAAAGATTT -> AGGAGTGGACAAAGATTTA
ACGTCAAAGCGACGACACG -> CGTCAAAGCGACGACACGA
ACTGTCCTACTATCCACGA -> CTGTCCTACTATCCACGAT
CATGCGAAATTGAGGTTCG -> ATGCGAAATTGAGGTTCGA
GTAAGCCTTTATGGCCAAT -> TAAGCCTTTATGGCCAATA
AAAACTCTTAAAGGGCCTA -> AAACTCTTAAAGGGCCTAC
GGTTAGTGCCGATCGGAAT -> GTTAGTGCCGATCGGAATG
TGTACCCCCAAAGGGTCCC -> GTACCCCCAAAGGGTCCCT
GGTGCATCATATAACCCAA -> GTGCATCATATAACCCAAG
CAACAGGTCATGCGAAATT -> AACAGGTCATGCGAAATTG
TAAAAATCTGTATTTTATC -> AAAAATCTGTATTTTATCA
GCTCTAGGGACGGTTAGTG -> CTCTAGGGACGGTTAGTGC
GCATCATATAACCCAAGCT -> CATCATATAACCCAAGCTC
CATTAGGATGCCACCACAT -> ATTAGGATGCCACCACATG
ACTTCGTGTCGGTGCATCA -> CTTCGTGTCGGTGCATCAT
AAAGTATTACGAGCCTATA -> AAGTATTACGAGCCTATAA
AAGGTAGAATTGTAGACAT -> AGGTAGAATTGTAGACATA
AGCCAATACACTGTTTAAC -> GCCAATACACTGTTTAACA
AACACAGATCAGACCGTTG -> ACACAGATCAGACCGTTGT
TTGTAAGGCGGTCGGAGGT -> TGTAAGGCGGTCGGAGGTA
ACCACTTGTAAGGCGGTCG -> CCACTTGTAAGGCGGTCGG
ATGGAGCATAGCGCAACTG -> TGGAGCATAGCGCAACTGG
GGATGATTTACACGACACC -> GATGATTTACACGACACCC
CTATAGATATGCATGAACA -> TATAGATATGCATGAACAC
GTCGTGTAAGTGCAAACGT -> TCGTGTAAGTGCAAACGTC
GGGAGTGTGCATTTATAAG -> GGAGTGTGCATTTATAAGC
GGTCGCGCGGCTTCGTAAA -> GTCGCGCGGCTTCGTAAAT
CCTATACTACCGATCGGAT -> CTATACTACCGATCGGATT
CCATCAGCCTGTTACCACC -> CATCAGCCTGTTACCACCT
CTTCGTAAGCCTTTATGGC -> TTCGTAAGCCTTTATGGCC
CGTCAAAGCGACGACACGA -> GTCAAAGCGACGACACGAT
TGGATATGATTGCTAACAT -> GGATATGATTGCTAACATC
AAAGAGTTTACGCCCTAGA -> AAGAGTTTACGCCCTAGAA
AATAGGGAGGACGAAATTT -> ATAGGGAGGACGAAATTTA
GTTGTAATGATGTACCCCC -> TTGTAATGATGTACCCCCA
ATAAATTGACAAGAGCACG -> TAAATTGACAAGAGCACGG
AGTCATTAGGATGCCACCA -> GTCATTAGGATGCCACCAC
ATTAAGAGCTTCATTACGG -> TTAAGAGCTTCATTACGGA
ACAGATCAGACCGTTGTAA -> CAGATCAGACCGTTGTAAT
ATGCATGAACACGAAGTGC -> TGCATGAACACGAAGTGCC
GAGTATAACGCAATTATAT -> AGTATAACGCAATTATATC
ACCAGAATAAAACTCTTAA -> CCAGAATAAAACTCTTAAA
AATACCCGGACGGATACCC -> ATACCCGGACGGATACCCG
TGTCCTTGAATCAATAGAG -> GTCCTTGAATCAATAGAGG
CGGCACATGTACACAGTTC -> GGCACATGTACACAGTTCT
TTACGGAGGCGTGAAGTTC -> TACGGAGGCGTGAAGTTCT
ACGCTCTGTAACTTTAATT -> CGCTCTGTAACTTTAATTT
AGTCTCATGTGTTTCGGTG -> GTCTCATGTGTTTCGGTGA
GGCGGGTATTTAGATGGCC -> GCGGGTATTTAGATGGCCG
GAATTGTCTACAAACCTAG -> AATTGTCTACAAACCTAGT
CGGATCAAAAGATCGTCTC -> GGATCAAAAGATCGTCTCA
TTATGTCGATGCCTGCGTG -> TATGTCGATGCCTGCGTGT
CATGTACATAAATACGGAT -> ATGTACATAAATACGGATG
TTACTACCTACTTCTAAAT -> TACTACCTACTTCTAAATC
TACGGATGATTTACACGAC -> ACGGATGATTTACACGACA
CAACATCCCCGGATAAACG -> AACATCCCCGGATAAACGA
GATCAAAAGATCGTCTCAG -> ATCAAAAGATCGTCTCAGT
CGGGTTATGTCGATGCCTG -> GGGTTATGTCGATGCCTGC
GTGAGCTTCCAGTCGAGCA -> TGAGCTTCCAGTCGAGCAG
CCGGCCCATCCATCGACTA -> CGGCCCATCCATCGACTAA
TAGAATTGTAGACATAGCC -> AGAATTGTAGACATAGCCA
CAAAGATTTAAGCGCACCC -> AAAGATTTAAGCGCACCCA
TATACTACCGATCGGATTC -> ATACTACCGATCGGATTCC
CGATAAAATTCTCATTAGG -> GATAAAATTCTCATTAGGA
ATCTTGCCGGCCCATCCAT -> TCTTGCCGGCCCATCCATC
TAAATCGCGGGCAGAAGAC -> AAATCGCGGGCAGAAGACC
ACAACCAGAATAAAACTCT -> CAACCAGAATAAAACTCTT
GAATAGTCGTGTCCCAGTC -> AATAGTCGTGTCCCAGTCG
TGGATCTCGACGCATAGAC -> GGATCTCGACGCATAGACA
CGAAGTGCCGAGCATCATA -> GAAGTGCCGAGCATCATAA
TTCTCACTAAACGTCCTAT -> TCTCACTAAACGTCCTATA
ATCATACGTTAGCAGCATG -> TCATACGTTAGCAGCATGT
AATAAAGCTAGGGTAGCAA -> ATAAAGCTAGGGTAGCAAA
AGCTCAGGAGTGGACAAAG -> GCTCAGGAGTGGACAAAGA
ATATGCATGAACACGAAGT -> TATGCATGAACACGAAGTG
CTCTGATCTAGATGATCAT -> TCTGATCTAGATGATCATA
TTCTTTCATATGGCGGTAT -> TCTTTCATATGGCGGTATG
TCTCATTAGGATGCCACCA -> CTCATTAGGATGCCACCAC
CCTCTCGATAAAGTATTAC -> CTCTCGATAAAGTATTACG
GTCATGCGAAATTGAGGTT -> TCATGCGAAATTGAGGTTC
ATCGCGGGCAGAAGACCGG -> TCGCGGGCAGAAGACCGGA
TGTAGCATTCTAATAAAGC -> GTAGCATTCTAATAAAGCT
GCAGATGATTAAACACCGG -> CAGATGATTAAACACCGGG
GTACCCCCAAAGGGTCCCT -> TACCCCCAAAGGGTCCCTG
GCAAACGTCAAAGCGACGA -> CAAACGTCAAAGCGACGAC
CAATCTTCTCACTAAACGT -> AATCTTCTCACTAAACGTC
CATTAGGATGCCACCACTT -> ATTAGGATGCCACCACTTG
ATAAAGCTAGGGTAGCAAA -> TAAAGCTAGGGTAGCAAAC
GGCACCCCAAGCAAGTGCA -> GCACCCCAAGCAAGTGCAG
GATCGTCTCAGTCATTAGG -> ATCGTCTCAGTCATTAGGA
GCTCTGTAACTTTAATTTG -> CTCTGTAACTTTAATTTGG
GCTTCATTACGGAGGCGTG -> CTTCATTACGGAGGCGTGA
TCCCAGTCGGGGCACCCCA -> CCCAGTCGGGGCACCCCAA
AGGGATCCAATTACCCCGA -> GGGATCCAATTACCCCGAA
GAATGTTAGTAAATGCCAG -> AATGTTAGTAAATGCCAGA
GAGGTTCGAGCTAAGATTG -> AGGTTCGAGCTAAGATTGG
CTTAGACTACCTATGGCGT -> TTAGACTACCTATGGCGTA
CCTTAGACTACCTATGGCG -> CTTAGACTACCTATGGCGT
ACTCCTGAGGGGTATGGGA -> CTCCTGAGGGGTATGGGAA
TTCTTTCAGCTCAGGAGTG -> TCTTTCAGCTCAGGAGTGG
GTTGACAAACAAGCTCTAG -> TTGACAAACAAGCTCTAGG
CAAGAGCACGGCAGACTCC -> AAGAGCACGGCAGACTCCT
CACAGATCAGACCGTTGTA -> ACAGATCAGACCGTTGTAA
GAAATTGAGGTTCGAGCTA -> AAATTGAGGTTCGAGCTAA
CCTGAGGGGTATGGGAATT -> CTGAGGGGTATGGGAATTG
GTGCATCATATAACCCAAG -> TGCATCATATAACCCAAGC
GTTCTACTGGCGCCTGGTC -> TTCTACTGGCGCCTGGTCT
GCCTTTATGGCCAATACCC -> CCTTTATGGCCAATACCCG
AGACCGGATCAAAAGATCG -> GACCGGATCAAAAGATCGT
GGAGGCGTGAAGTTCTATT -> GAGGCGTGAAGTTCTATTA
TGTTATCGGAGGTATATTC -> GTTATCGGAGGTATATTCT
CAAGCTCTAGGGACGGTTA -> AAGCTCTAGGGACGGTTAG
GTAAGGCGGTCGGAGGTAT -> TAAGGCGGTCGGAGGTATA
TAAAGTATTACGAGCCTAT -> AAAGTATTACGAGCCTATA
ACGTCCTATACTACCGATC -> CGTCCTATACTACCGATCG
CCGCCTGACCTTCCCTATA -> CGCCTGACCTTCCCTATAA
GAAATAGTACAACCAGAAT -> AAATAGTACAACCAGAATA
TCCAGATAGTCTCATGTGT -> CCAGATAGTCTCATGTGTT
TCGCTGGCAACATCCCCGG -> CGCTGGCAACATCCCCGGA
AACCAGAATAAAACTCTTA -> ACCAGAATAAAACTCTTAA
CTAATAAAGCTAGGGTAGC -> TAATAAAGCTAGGGTAGCA
GGATGCCACCACATGTGAC -> GATGCCACCACATGTGACG
CGCTCTGTAACTTTAATTT -> GCTCTGTAACTTTAATTTG
TCGGAGGTATATTCTTTCA -> CGGAGGTATATTCTTTCAT,CGGAGGTATATTCTTTCAG,CGGAGGTATATTCTTTCAT,CGGAGGTATATTCTTTCAG
ATAGTCTCATGTGTTTCGG -> TAGTCTCATGTGTTTCGGT
TAGCGCAACTGGAGGACCG -> AGCGCAACTGGAGGACCGC
CCCAAAGGGTCCCTGAGGA -> CCAAAGGGTCCCTGAGGAG
AGAAAAAAGAGTTTACGCC -> GAAAAAAGAGTTTACGCCC
TCACTAAACGTCCTATACT -> CACTAAACGTCCTATACTA
TACACGACACCCCTAGATG -> ACACGACACCCCTAGATGA
ACGGGAGTGTGCATTTATA -> CGGGAGTGTGCATTTATAA
CGGGCGCAATCCATTATGT -> GGGCGCAATCCATTATGTC
CCGTTGCACTCCCCGGCCA -> CGTTGCACTCCCCGGCCAT
TTCTAATAAAGCTAGGGTA -> TCTAATAAAGCTAGGGTAG
CGTCCACTCCGCGTGCAAC -> GTCCACTCCGCGTGCAACC
ACGATACGGAGTAATGACA -> CGATACGGAGTAATGACAG
CGGCGGGTATTTAGATGGC -> GGCGGGTATTTAGATGGCC
TCTCCCTACGCAAGGTCGC -> CTCCCTACGCAAGGTCGCG
GAGTTTACGCCCTAGAATA -> AGTTTACGCCCTAGAATAA
TACACTGTTTAACACAGAT -> ACACTGTTTAACACAGATC
CACTTCGTGTCGGTGCATC -> ACTTCGTGTCGGTGCATCA
CTGTAACTTTAATTTGGAC -> TGTAACTTTAATTTGGACA
AAAATATCGAATGTTAGTA -> AAATATCGAATGTTAGTAA
TATGGCGTACGGGAGTGTG -> ATGGCGTACGGGAGTGTGC
GGATATGATTGCTAACATC -> GATATGATTGCTAACATCA
AAAGCGACGACACGATACG -> AAGCGACGACACGATACGG
GATACCGTGTGCAATCTTC -> ATACCGTGTGCAATCTTCT
GCACATGTACACAGTTCTG -> CACATGTACACAGTTCTGG
ATGATGCTCAATGTGGAGT -> TGATGCTCAATGTGGAGTA
GCAACTGGAGGACCGCGGA -> CAACTGGAGGACCGCGGAC
GTGTCATGAGATGAACTGG -> TGTCATGAGATGAACTGGT
AATTGTCTACAAACCTAGT -> ATTGTCTACAAACCTAGTT
GCGCAATCCATTATGTCTG -> CGCAATCCATTATGTCTGT
AAGGGCCTACAACTCTCCC -> AGGGCCTACAACTCTCCCT
GTAGCATTCTAATAAAGCT -> TAGCATTCTAATAAAGCTA
AACTTTAATTTGGACACCG -> ACTTTAATTTGGACACCGC
ACCCGCCTGACCTTCCCTA -> CCCGCCTGACCTTCCCTAT
GCCGTAATGTGTCATGAGA -> CCGTAATGTGTCATGAGAT
TACTACCGATCGGATTCCT -> ACTACCGATCGGATTCCTA
TGCATCATATAACCCAAGC -> GCATCATATAACCCAAGCT
AAAGATCGTCTCAGTCATT -> AAGATCGTCTCAGTCATTA
GTGACGCCATCGGAGGTAT -> TGACGCCATCGGAGGTATA
GCCCTAGAATAATAAGGAT -> CCCTAGAATAATAAGGATA
AATGATGTACCCCCAAAGG -> ATGATGTACCCCCAAAGGG
TCTACAAACCTAGTTAATT -> CTACAAACCTAGTTAATTA
TCAGCTCAGGAGTGGACAA -> CAGCTCAGGAGTGGACAAA
TAATTTGGACACCGCAGTT -> AATTTGGACACCGCAGTTA
CACGTGAGCCCTTAGACTA -> ACGTGAGCCCTTAGACTAC
CATACTCGTAAGCGGAGAC -> ATACTCGTAAGCGGAGACC
GAGGTATATTCTTTCAGCT -> AGGTATATTCTTTCAGCTC
TGAATCAATAGAGGTAAAT -> GAATCAATAGAGGTAAATG
ATGCCACCACTTGTAAGGC -> TGCCACCACTTGTAAGGCG
ACTCCACGTGAGCCCTTAG -> CTCCACGTGAGCCCTTAGA
CAATTACCCCGAAAGACTC -> AATTACCCCGAAAGACTCC
ATGAACTGGTTCTACTGGC -> TGAACTGGTTCTACTGGCG
TTATATCTGTCCTTGAATC -> TATATCTGTCCTTGAATCA
CAACCCTCGATACCGTGTG -> AACCCTCGATACCGTGTGC
TTACCCCGAAAGACTCCAC -> TACCCCGAAAGACTCCACG
ATACCCGCCTGACCTTCCC -> TACCCGCCTGACCTTCCCT
TATTTTATCATACGTTAGC -> ATTTTATCATACGTTAGCA
ATTGACAAGAGCACGGCAG -> TTGACAAGAGCACGGCAGA
GAGACCACGTCGTGATCCC -> AGACCACGTCGTGATCCCC
GGTCCCTGAGGAGTATAAT -> GTCCCTGAGGAGTATAATT
ATCATAATTGCCGTCGCTG -> TCATAATTGCCGTCGCTGG
CACCACGTCACGCTCACCC -> ACCACGTCACGCTCACCCG
ACGAAGTGCCGAGCATCAT -> CGAAGTGCCGAGCATCATA
TACGGAGGCGTGAAGTTCT -> ACGGAGGCGTGAAGTTCTA
AAATTTAAATTCCTGCTTT -> AATTTAAATTCCTGCTTTG
TATGGCGGTATGACTAGGC -> ATGGCGGTATGACTAGGCG
AACGCAATTATATCTGTCC -> ACGCAATTATATCTGTCCT
ACAGGTCATGCGAAATTGA -> CAGGTCATGCGAAATTGAG
CTAGGCGGGCGCAATCCAT -> TAGGCGGGCGCAATCCATT
AATTCTCATTAGGATGCCA -> ATTCTCATTAGGATGCCAC
AAAAGAGTTTACGCCCTAG -> AAAGAGTTTACGCCCTAGA
ATCTTCTCACTAAACGTCC -> TCTTCTCACTAAACGTCCT
TTCATTACGGAGGCGTGAA -> TCATTACGGAGGCGTGAAG
TAGCAAACTCTGATCTAGA -> AGCAAACTCTGATCTAGAT
GGGTAGCAAACTCTGATCT -> GGTAGCAAACTCTGATCTA
GTCTACCTGCGTAAAGGTA -> TCTACCTGCGTAAAGGTAG
TGTTAATCGGCGCCACTTC -> GTTAATCGGCGCCACTTCG
CCGGCTGTGGTCCATAATA -> CGGCTGTGGTCCATAATAT
GGGCCGTAATGTGTCATGA -> GGCCGTAATGTGTCATGAG
TATTCTTTCATGCGGCGGG -> ATTCTTTCATGCGGCGGGT
GCGTTTATAGGTCGTTCAT -> CGTTTATAGGTCGTTCATG
GGCGCCTGGTCTGCGGCAA -> GCGCCTGGTCTGCGGCAAA
TACGTTAGCAGCATGTACA -> ACGTTAGCAGCATGTACAT
TATGACTAGGCGGGCGCAA -> ATGACTAGGCGGGCGCAAT
TATATTCTTTCATGCGGCG -> ATATTCTTTCATGCGGCGG
CTAGAAAAAAGAGTTTACG -> TAGAAAAAAGAGTTTACGC
TACTGGCGCCTGGTCTGCG -> ACTGGCGCCTGGTCTGCGG
GTATGGGAATTGTCTACAA -> TATGGGAATTGTCTACAAA
GTATTACGAGCCTATAAAG -> TATTACGAGCCTATAAAGG
TATGTCGTGTAAGTGCAAA -> ATGTCGTGTAAGTGCAAAC
GATGCCACCACTTGTAAGG -> ATGCCACCACTTGTAAGGC
CTACCTGCGTAAAGGTAGA -> TACCTGCGTAAAGGTAGAA
TCTCATGTGTTTCGGTGAG -> CTCATGTGTTTCGGTGAGG
TCTTTCAGCTCAGGAGTGG -> CTTTCAGCTCAGGAGTGGA
AATTCCCTCGTCCCTTATA -> ATTCCCTCGTCCCTTATAC
GGAATGTAGCATTCTAATA -> GAATGTAGCATTCTAATAA
GGATCCAATTACCCCGAAA -> GATCCAATTACCCCGAAAG
CATAGCGCAACTGGAGGAC -> ATAGCGCAACTGGAGGACC
TGAGGAGTATAATTCCCTC -> GAGGAGTATAATTCCCTCG
CGTAGTTGGATCTCGACGC -> GTAGTTGGATCTCGACGCA
CTGTGGTCCATAATATCAG -> TGTGGTCCATAATATCAGT
ATTCCTAGTCCCCCTATTC -> TTCCTAGTCCCCCTATTCC
AGGTTCTGAAATAGTACAA -> GGTTCTGAAATAGTACAAC
ACCTTACTTGGTTTGAACG -> CCTTACTTGGTTTGAACGC
GCAATCTTCTCACTAAACG -> CAATCTTCTCACTAAACGT
CCCCGAAAGACTCCACGTG -> CCCGAAAGACTCCACGTGA
CTAGTGTAAAAATCTGTAT -> TAGTGTAAAAATCTGTATT
CGGTGAGGTGAGCTGCCTT -> GGTGAGGTGAGCTGCCTTG
GGCAGACTCCTGAGGGGTA -> GCAGACTCCTGAGGGGTAT
AGTGTAAAAATCTGTATTT -> GTGTAAAAATCTGTATTTT
CCGCGTGCAACCTGATACG -> CGCGTGCAACCTGATACGC
GTAAGCGGAGACCACGTCG -> TAAGCGGAGACCACGTCGT
CATGAACACGAAGTGCCGA -> ATGAACACGAAGTGCCGAG
CAGAATTTTTCGTAGTTGG -> AGAATTTTTCGTAGTTGGA
AGTTAATTATGTTAATCGG -> GTTAATTATGTTAATCGGC
TGACAAGAGCACGGCAGAC -> GACAAGAGCACGGCAGACT
ACGCGTTTATAGGTCGTTC -> CGCGTTTATAGGTCGTTCA
CTGCTTTGCTTATGCCGCC -> TGCTTTGCTTATGCCGCCA
CGTGTCCCAGTCGGGGCAC -> GTGTCCCAGTCGGGGCACC
ATTGTCTACAAACCTAGTT -> TTGTCTACAAACCTAGTTA
CATCGACTAATAGGGAGGA -> ATCGACTAATAGGGAGGAC
CGTTTGTTATCGGAGGTAT -> GTTTGTTATCGGAGGTATA
GCGAAATTGAGGTTCGAGC -> CGAAATTGAGGTTCGAGCT
TACTTCTAAATCGCGGGCA -> ACTTCTAAATCGCGGGCAG
GTCGGAGGTATATTCTTTC -> TCGGAGGTATATTCTTTCA
TGCAGTGTACTGTCCTACT -> GCAGTGTACTGTCCTACTA
TAAGGCGGTCGGAGGTATA -> AAGGCGGTCGGAGGTATAT
GCACCCCAAGCAAGTGCAG -> CACCCCAAGCAAGTGCAGT
CGGTGCATCATATAACCCA -> GGTGCATCATATAACCCAA
GTTAGTAAATGCCAGAATT -> TTAGTAAATGCCAGAATTT
ACCCTCGATACCGTGTGCA -> CCCTCGATACCGTGTGCAA
TTTTCCAGATAGTCTCATG -> TTTCCAGATAGTCTCATGT
AGGAGTGGACAAAGATTTA -> GGAGTGGACAAAGATTTAA
CAAAGCGTCCACTCCGCGT -> AAAGCGTCCACTCCGCGTG
CCAAGCTCTTCGTAAGCCT -> CAAGCTCTTCGTAAGCCTT
TCGCGGGCAGAAGACCGGA -> CGCGGGCAGAAGACCGGAT
GGTATTTAGATGGCCGTTG -> GTATTTAGATGGCCGTTGC
CACTCCGCGTGCAACCTGA -> ACTCCGCGTGCAACCTGAT
CGGTTAGTGCCGATCGGAA -> GGTTAGTGCCGATCGGAAT
CTCGGAGGTATATTCTTTC -> TCGGAGGTATATTCTTTCA
TGCCACCACCAGCTTTAAG -> GCCACCACCAGCTTTAAGC
TGGCGCCTGGTCTGCGGCA -> GGCGCCTGGTCTGCGGCAA
AATTGTAGACATAGCCAAT -> ATTGTAGACATAGCCAATA
AGGGTAGCAAACTCTGATC -> GGGTAGCAAACTCTGATCT
GAGCTTCCAGTCGAGCAGA -> AGCTTCCAGTCGAGCAGAG
CGCCTGGTCTGCGGCAAAG -> GCCTGGTCTGCGGCAAAGC
CCAGATAGTCTCATGTGTT -> CAGATAGTCTCATGTGTTT
ACTACCGATCGGATTCCTA -> CTACCGATCGGATTCCTAG
TGCGCAACTACACACCGAC -> GCGCAACTACACACCGACA
GTAACTTTAATTTGGACAC -> TAACTTTAATTTGGACACC
CAATACACTGTTTAACACA -> AATACACTGTTTAACACAG
TATCATACGTTAGCAGCAT -> ATCATACGTTAGCAGCATG
CTTCCAGTCGAGCAGAGAC -> TTCCAGTCGAGCAGAGACG
ATGCCACCACATGTGACGC -> TGCCACCACATGTGACGCC
AACATCAAATCTTGCCGGC -> ACATCAAATCTTGCCGGCC
ATTCTTTCAGCTCAGGAGT -> TTCTTTCAGCTCAGGAGTG
TCTCACTAAACGTCCTATA -> CTCACTAAACGTCCTATAC
AGCTCGGAGGTATATTCTT -> GCTCGGAGGTATATTCTTT
CAGGTCATGCGAAATTGAG -> AGGTCATGCGAAATTGAGG
TGTGCAATCTTCTCACTAA -> GTGCAATCTTCTCACTAAA
AAGCGCACCCATTACTACC -> AGCGCACCCATTACTACCT
TTGGATCGCATCATTAGGA -> TGGATCGCATCATTAGGAT
TCCAATTACCCCGAAAGAC -> CCAATTACCCCGAAAGACT
AAAGATTTAAGCGCACCCA -> AAGATTTAAGCGCACCCAT
CAGAGTCTATGTACTAGTG -> AGAGTCTATGTACTAGTGT
ATAAAATTCTCATTAGGAT -> TAAAATTCTCATTAGGATG
GGCGGTATGACTAGGCGGG -> GCGGTATGACTAGGCGGGC
CTGACCTTCCCTATAACAC -> TGACCTTCCCTATAACACT
GTAAATGCCAGAATTTTTC -> TAAATGCCAGAATTTTTCG
CATCGGAGGTATATTCTTT -> ATCGGAGGTATATTCTTTC
ACTTGTAAGGCGGTCGGAG -> CTTGTAAGGCGGTCGGAGG
GTCTATGTACTAGTGTAAA -> TCTATGTACTAGTGTAAAA
GGTTTGAACGCACTAAATC -> GTTTGAACGCACTAAATCT
CGTAAATATGAACACCACG -> GTAAATATGAACACCACGT
TTTACGCCCTAGAATAATA -> TTACGCCCTAGAATAATAA
ATCCATCGACTAATAGGGA -> TCCATCGACTAATAGGGAG
GGTATGGGAATTGTCTACA -> GTATGGGAATTGTCTACAA
ACCACCAGCTTTAAGCTCG -> CCACCAGCTTTAAGCTCGG
GCATAGACACAACTCCCTA -> CATAGACACAACTCCCTAG
CCTGGTCTGCGGCAAAGCG -> CTGGTCTGCGGCAAAGCGT
GTGAAGTTCTATTATTTTC -> TGAAGTTCTATTATTTTCC
CAGATGATTAAACACCGGG -> AGATGATTAAACACCGGGT
TGTCATGAGATGAACTGGT -> GTCATGAGATGAACTGGTT
TTCGTAAATATGAACACCA -> TCGTAAATATGAACACCAC
ACTATAGATATGCATGAAC -> CTATAGATATGCATGAACA
GGCAGAAGACCGGATCAAA -> GCAGAAGACCGGATCAAAA
ACTTCATTAGGATGCCACC -> CTTCATTAGGATGCCACCA
TTCTCATTAGGATGCCACC -> TCTCATTAGGATGCCACCA
AGAAGAACAGTTGACAAAC -> GAAGAACAGTTGACAAACA
TGATTAAGAGCTTCATTAC -> GATTAAGAGCTTCATTACG
GTATTTAGATGGCCGTTGC -> TATTTAGATGGCCGTTGCA
TCAGTCATTAGGATGCCAC -> CAGTCATTAGGATGCCACC
TAAACACCGGGTTATGTCG -> AAACACCGGGTTATGTCGA
AGGATGCCACCACATGTGA -> GGATGCCACCACATGTGAC
AGTTCTATTATTTTCCAGA -> GTTCTATTATTTTCCAGAT
TAGGATGCCACCACATGTG -> AGGATGCCACCACATGTGA
ATAGCCAATACACTGTTTA -> TAGCCAATACACTGTTTAA
TCTTGCGCAACTACACACC -> CTTGCGCAACTACACACCG
TTATGTCTGTGAGCTTCCA -> TATGTCTGTGAGCTTCCAG
TGGACAAAGATTTAAGCGC -> GGACAAAGATTTAAGCGCA
TACGCAAGGTCGCGCGGCT -> ACGCAAGGTCGCGCGGCTT
AAGTATTACGAGCCTATAA -> AGTATTACGAGCCTATAAA
CTCGATAAAGTATTACGAG -> TCGATAAAGTATTACGAGC
TGGCGTACGGGAGTGTGCA -> GGCGTACGGGAGTGTGCAT
TACTACCTACTTCTAAATC -> ACTACCTACTTCTAAATCG
CTTATGCCGCCATACTCGT -> TTATGCCGCCATACTCGTA
GCTAGGGTAGCAAACTCTG -> CTAGGGTAGCAAACTCTGA
CATGTGACGCCATCGGAGG -> ATGTGACGCCATCGGAGGT
GGTCGGAGGTATATTCTTT -> GTCGGAGGTATATTCTTTC
TCGATACCGTGTGCAATCT -> CGATACCGTGTGCAATCTT
CCTATTCCGCCAGAAGAAC -> CTATTCCGCCAGAAGAACA
TACCCCCAAAGGGTCCCTG -> ACCCCCAAAGGGTCCCTGA
AGCTGGTCTTGCGCAACTA -> GCTGGTCTTGCGCAACTAC
CACCGACACTAATTTAAAA -> ACCGACACTAATTTAAAAA
AGATGATCATAAAGCAGTA -> GATGATCATAAAGCAGTAC
GAACACGAAGTGCCGAGCA -> AACACGAAGTGCCGAGCAT
TGTAAAAATCTGTATTTTA -> GTAAAAATCTGTATTTTAT
TGTAACTTTAATTTGGACA -> GTAACTTTAATTTGGACAC
CGACACGATACGGAGTAAT -> GACACGATACGGAGTAATG
TCCCCGGATAAACGAGCTT -> CCCCGGATAAACGAGCTTT
TTTAAATTCCTGCTTTGCT -> TTAAATTCCTGCTTTGCTT
GTAAGTGCAAACGTCAAAG -> TAAGTGCAAACGTCAAAGC
AAAAAAGAGTTTACGCCCT -> AAAAAGAGTTTACGCCCTA
GAAGTGCCGAGCATCATAA -> AAGTGCCGAGCATCATAAT
GACAGTCTACCTGCGTAAA -> ACAGTCTACCTGCGTAAAG
ATTTTCCAGATAGTCTCAT -> TTTTCCAGATAGTCTCATG
GAGCTAAGATTGGTTCCAG -> AGCTAAGATTGGTTCCAGG
TGTTAGTAAATGCCAGAAT -> GTTAGTAAATGCCAGAATT
CCACGATAAAATTCTCATT -> CACGATAAAATTCTCATTA
TAATGATGTACCCCCAAAG -> AATGATGTACCCCCAAAGG
TGTGGATATGATTGCTAAC -> GTGGATATGATTGCTAACA
CTAAGATTGGTTCCAGGGA -> TAAGATTGGTTCCAGGGAT
GATTCCTAGTCCCCCTATT -> ATTCCTAGTCCCCCTATTC
TATAGATATGCATGAACAC -> ATAGATATGCATGAACACG
TAGATGATCATAAAGCAGT -> AGATGATCATAAAGCAGTA
CCACGTCACGCTCACCCGG -> CACGTCACGCTCACCCGGC
TCCCCTGTCACAACCCTCG -> CCCCTGTCACAACCCTCGA
GCGCAACTGGAGGACCGCG -> CGCAACTGGAGGACCGCGG
AAGCTCTAGGGACGGTTAG -> AGCTCTAGGGACGGTTAGT
GGTATATTCTTTCAGTAAA -> GTATATTCTTTCAGTAAAA
GCACGACAATCACTATAGA -> CACGACAATCACTATAGAT
ACACTAATTTAAAAATAAA -> CACTAATTTAAAAATAAAT
GCCTGGTCTGCGGCAAAGC -> CCTGGTCTGCGGCAAAGCG
AGTATAACGCAATTATATC -> GTATAACGCAATTATATCT
CACCCCAAGCAAGTGCAGT -> ACCCCAAGCAAGTGCAGTG
CGCGCGGCTTCGTAAATAT -> GCGCGGCTTCGTAAATATG
TTGCCGTCGCTGGCAACAT -> TGCCGTCGCTGGCAACATC
AGAGCTTCATTACGGAGGC -> GAGCTTCATTACGGAGGCG
TTGTCCGGATATCGGCACA -> TGTCCGGATATCGGCACAT
ACGGCAGACTCCTGAGGGG -> CGGCAGACTCCTGAGGGGT
GTTTAACACAGATCAGACC -> TTTAACACAGATCAGACCG
ATTAGGATGCCACCACATG -> TTAGGATGCCACCACATGT
CAGAGACGCGTTTATAGGT -> AGAGACGCGTTTATAGGTC
CGGATACCCGCCTGACCTT -> GGATACCCGCCTGACCTTC
ATCAGACCGTTGTAATGAT -> TCAGACCGTTGTAATGATG
TCCAGTCGAGCAGAGACGC -> CCAGTCGAGCAGAGACGCG
GTGTGCAATCTTCTCACTA -> TGTGCAATCTTCTCACTAA
TTGCTTATGCCGCCATACT -> TGCTTATGCCGCCATACTC
TCGTCTCAGTCATTAGGAT -> CGTCTCAGTCATTAGGATG
AGAGACGCGTTTATAGGTC -> GAGACGCGTTTATAGGTCG
TGGCGGTATGACTAGGCGG -> GGCGGTATGACTAGGCGGG
TAGAATAATAAGGATATAA -> AGAATAATAAGGATATAAC
CGCGTGCAACCTGATACGC -> GCGTGCAACCTGATACGCT
TCTGTATTTTATCATACGT -> CTGTATTTTATCATACGTT
AAGAGTTTACGCCCTAGAA -> AGAGTTTACGCCCTAGAAT
ACCTGCGTAAAGGTAGAAT -> CCTGCGTAAAGGTAGAATT
CCTACAACTCTCCCTTGTC -> CTACAACTCTCCCTTGTCC
AATGCCAGAATTTTTCGTA -> ATGCCAGAATTTTTCGTAG
GTCTTGCGCAACTACACAC -> TCTTGCGCAACTACACACC
GAGGAATAGTCGTGTCCCA -> AGGAATAGTCGTGTCCCAG
GTTCTGAAATAGTACAACC -> TTCTGAAATAGTACAACCA
TAGGGACGGTTAGTGCCGA -> AGGGACGGTTAGTGCCGAT
CCTTACTTGGTTTGAACGC -> CTTACTTGGTTTGAACGCA
CCTAGAATAATAAGGATAT -> CTAGAATAATAAGGATATA
AACCCAAGCTCTTCGTAAG -> ACCCAAGCTCTTCGTAAGC
AGACTCCACGTGAGCCCTT -> GACTCCACGTGAGCCCTTA
ACCGTGTGCAATCTTCTCA -> CCGTGTGCAATCTTCTCAC
CCGTGTGCAATCTTCTCAC -> CGTGTGCAATCTTCTCACT
GCGGCAAAGCGTCCACTCC -> CGGCAAAGCGTCCACTCCG
CAATAGAGGTAAATGGAGC -> AATAGAGGTAAATGGAGCA
TGATCTAGATGATCATAAA -> GATCTAGATGATCATAAAG
ACATAGCCAATACACTGTT -> CATAGCCAATACACTGTTT
CTCCCTTGTCCGGATATCG -> TCCCTTGTCCGGATATCGG
TCGTAGTTGGATCTCGACG -> CGTAGTTGGATCTCGACGC
GCGTACGGGAGTGTGCATT -> CGTACGGGAGTGTGCATTT
GTGCAGTGTACTGTCCTAC -> TGCAGTGTACTGTCCTACT
CTTTGCTTATGCCGCCATA -> TTTGCTTATGCCGCCATAC
AGAATAATAAGGATATAAC -> GAATAATAAGGATATAACC
AACGCACTAAATCTCCCTA -> ACGCACTAAATCTCCCTAC
TAGTGCCGATCGGAATGTA -> AGTGCCGATCGGAATGTAG
TCTTGCCGGCCCATCCATC -> CTTGCCGGCCCATCCATCG
TCCATAATATCAGTGTAAA -> CCATAATATCAGTGTAAAT
TGCAACCTGATACGCTCTG -> GCAACCTGATACGCTCTGT
ATTACGAGCCTATAAAGGT -> TTACGAGCCTATAAAGGTT
AGGTGAGCTGCCTTGGATC -> GGTGAGCTGCCTTGGATCG
TGCATGAACACGAAGTGCC -> GCATGAACACGAAGTGCCG
ATATGAACACCACGTCACG -> TATGAACACCACGTCACGC
GAGGAGTATAATTCCCTCG -> AGGAGTATAATTCCCTCGT
TCATTAGGATGCCACCACG -> CATTAGGATGCCACCACGA
TCCACGTGAGCCCTTAGAC -> CCACGTGAGCCCTTAGACT
CTCCACGTGAGCCCTTAGA -> TCCACGTGAGCCCTTAGAC
ACTAGTGTAAAAATCTGTA -> CTAGTGTAAAAATCTGTAT
AACACCGGGTTATGTCGAT -> ACACCGGGTTATGTCGATG
TGAGGGGTATGGGAATTGT -> GAGGGGTATGGGAATTGTC
ACAGTTGACAAACAAGCTC -> CAGTTGACAAACAAGCTCT
TAGACATAGCCAATACACT -> AGACATAGCCAATACACTG
TTCCCTATAACACTTCATT -> TCCCTATAACACTTCATTA
CTGAGGGGTATGGGAATTG -> TGAGGGGTATGGGAATTGT
CCCTATTCCGCCAGAAGAA -> CCTATTCCGCCAGAAGAAC
CGGCGCCACTTCGTGTCGG -> GGCGCCACTTCGTGTCGGT
CCATACTCGTAAGCGGAGA -> CATACTCGTAAGCGGAGAC
GCACCCATTACTACCTACT -> CACCCATTACTACCTACTT
GGTAAATGGAGCATAGCGC -> GTAAATGGAGCATAGCGCA
GATAAACGAGCTTTGATTA -> ATAAACGAGCTTTGATTAA
AATAAATTGACAAGAGCAC -> ATAAATTGACAAGAGCACG
CGCCAGAAGAACAGTTGAC -> GCCAGAAGAACAGTTGACA
AAATATGAACACCACGTCA -> AATATGAACACCACGTCAC
GCGGTCGGAGGTATATTCT -> CGGTCGGAGGTATATTCTT
CACATGTGACGCCATCGGA -> ACATGTGACGCCATCGGAG
ACCCCCAAAGGGTCCCTGA -> CCCCCAAAGGGTCCCTGAG
ATGTCGTGTAAGTGCAAAC -> TGTCGTGTAAGTGCAAACG
GTACTAGCTATGCAGGCCT -> TACTAGCTATGCAGGCCTA
TTTCAGTAAAAATATCGAA -> TTCAGTAAAAATATCGAAT
CGCGGCTTCGTAAATATGA -> GCGGCTTCGTAAATATGAA
CGTTCATGATGCTCAATGT -> GTTCATGATGCTCAATGTG
CTAAATCTCCCTACGCAAG -> TAAATCTCCCTACGCAAGG
GCAGCATGTACATAAATAC -> CAGCATGTACATAAATACG
GAATTGTAGACATAGCCAA -> AATTGTAGACATAGCCAAT
CACCCATTACTACCTACTT -> ACCCATTACTACCTACTTC
TTCCTAGTCCCCCTATTCC -> TCCTAGTCCCCCTATTCCG
TGGTTTGAACGCACTAAAT -> GGTTTGAACGCACTAAATC
TTTATAAGCACGACAATCA -> TTATAAGCACGACAATCAC
CCCTAGATGAGGAATAGTC -> CCTAGATGAGGAATAGTCG
TTGACAAACAAGCTCTAGG -> TGACAAACAAGCTCTAGGG
TGCCACCACATGTGACGCC -> GCCACCACATGTGACGCCA
CTGCGTAAAGGTAGAATTG -> TGCGTAAAGGTAGAATTGT
ACCCAAGCTCTTCGTAAGC -> CCCAAGCTCTTCGTAAGCC
TTAAGCTCGGAGGTATATT -> TAAGCTCGGAGGTATATTC
ATCGGAATGTAGCATTCTA -> TCGGAATGTAGCATTCTAA
GATAAAGTATTACGAGCCT -> ATAAAGTATTACGAGCCTA
GCCTACAACTCTCCCTTGT -> CCTACAACTCTCCCTTGTC
TCCATCGACTAATAGGGAG -> CCATCGACTAATAGGGAGG
CTTGCGCAACTACACACCG -> TTGCGCAACTACACACCGA
AACCTAGTTAATTATGTTA -> ACCTAGTTAATTATGTTAA
TCGATGCCTGCGTGTGGAT -> CGATGCCTGCGTGTGGATA
CTATCCACGATAAAATTCT -> TATCCACGATAAAATTCTC
TCTTAAAGGGCCTACAACT -> CTTAAAGGGCCTACAACTC
CCGCGGACAACAGGTCATG -> CGCGGACAACAGGTCATGC
CACGCTCACCCGGCTGTGG -> ACGCTCACCCGGCTGTGGT
GCGACGACACGATACGGAG -> CGACGACACGATACGGAGT
AAGCTGGTCTTGCGCAACT -> AGCTGGTCTTGCGCAACTA
GTTGGATCTCGACGCATAG -> TTGGATCTCGACGCATAGA
CTTTCAGCTCAGGAGTGGA -> TTTCAGCTCAGGAGTGGAC
ACAACTCCCTAGAAAAAAG -> CAACTCCCTAGAAAAAAGA
CCTAGGCAGAGTCTATGTA -> CTAGGCAGAGTCTATGTAC
ATGTGACGCCATCGGAGGT -> TGTGACGCCATCGGAGGTA
AAGCTCGGAGGTATATTCT -> AGCTCGGAGGTATATTCTT
TCTGAAATAGTACAACCAG -> CTGAAATAGTACAACCAGA
AGATTGGTTCCAGGGATCC -> GATTGGTTCCAGGGATCCA
GCGCCTGGTCTGCGGCAAA -> CGCCTGGTCTGCGGCAAAG
ACACAACTCCCTAGAAAAA -> CACAACTCCCTAGAAAAAA
CACCGCAGTTATAATATGT -> ACCGCAGTTATAATATGTC
TAAGTGCAAACGTCAAAGC -> AAGTGCAAACGTCAAAGCG
ATAATTCCCTCGTCCCTTA -> TAATTCCCTCGTCCCTTAT
TTAATTTGGACACCGCAGT -> TAATTTGGACACCGCAGTT
TCTAGATGATCATAAAGCA -> CTAGATGATCATAAAGCAG
TTGTAATGATGTACCCCCA -> TGTAATGATGTACCCCCAA
GATATGCATGAACACGAAG -> ATATGCATGAACACGAAGT
GACAAGAGCACGGCAGACT -> ACAAGAGCACGGCAGACTC
GTTAGTGCCGATCGGAATG -> TTAGTGCCGATCGGAATGT
TATCAGTGTAAATAAAGCT -> ATCAGTGTAAATAAAGCTG
AGTGCAAACGTCAAAGCGA -> GTGCAAACGTCAAAGCGAC
GTGCAACCTGATACGCTCT -> TGCAACCTGATACGCTCTG
AGGTATATTCTTTCATGCG -> GGTATATTCTTTCATGCGG
GAGCCTATAAAGGTTCTGA -> AGCCTATAAAGGTTCTGAA
CTTCCCTATAACACTTCAT -> TTCCCTATAACACTTCATT
GATGAACTGGTTCTACTGG -> ATGAACTGGTTCTACTGGC
TTTGCTTATGCCGCCATAC -> TTGCTTATGCCGCCATACT
ACCTATGGCGTACGGGAGT -> CCTATGGCGTACGGGAGTG
GAGGACGAAATTTAAATTC -> AGGACGAAATTTAAATTCC
TCATGAGATGAACTGGTTC -> CATGAGATGAACTGGTTCT
GCCAATACACTGTTTAACA -> CCAATACACTGTTTAACAC
TACTGTCCTACTATCCACG -> ACTGTCCTACTATCCACGA
TGAGCTTCCAGTCGAGCAG -> GAGCTTCCAGTCGAGCAGA
ATAACCCAAGCTCTTCGTA -> TAACCCAAGCTCTTCGTAA
AGGGGTATGGGAATTGTCT -> GGGGTATGGGAATTGTCTA
AGAGGTAAATGGAGCATAG -> GAGGTAAATGGAGCATAGC
ATACGGATGATTTACACGA -> TACGGATGATTTACACGAC
CAAGCTCTTCGTAAGCCTT -> AAGCTCTTCGTAAGCCTTT
ATAGGGAGGACGAAATTTA -> TAGGGAGGACGAAATTTAA
AATTTAAAAATAAATTGAC -> ATTTAAAAATAAATTGACA
CTTGAATCAATAGAGGTAA -> TTGAATCAATAGAGGTAAA
CATAATATCAGTGTAAATA -> ATAATATCAGTGTAAATAA
ACCGATCGGATTCCTAGTC -> CCGATCGGATTCCTAGTCC
GGTTCGAGCTAAGATTGGT -> GTTCGAGCTAAGATTGGTT
ACCCATTACTACCTACTTC -> CCCATTACTACCTACTTCT
GGCTTCGTAAATATGAACA -> GCTTCGTAAATATGAACAC
TAATGACAGTCTACCTGCG -> AATGACAGTCTACCTGCGT
GTTCATGATGCTCAATGTG -> TTCATGATGCTCAATGTGG
ATGCGAAATTGAGGTTCGA -> TGCGAAATTGAGGTTCGAG
TTCATATGGCGGTATGACT -> TCATATGGCGGTATGACTA
CTGGAGGACCGCGGACAAC -> TGGAGGACCGCGGACAACA
CCACATGTGACGCCATCGG -> CACATGTGACGCCATCGGA
CTCAGTCATTAGGATGCCA -> TCAGTCATTAGGATGCCAC
TCGTGTAAGTGCAAACGTC -> CGTGTAAGTGCAAACGTCA
AACGTCCTATACTACCGAT -> ACGTCCTATACTACCGATC
GATTGGTTCCAGGGATCCA -> ATTGGTTCCAGGGATCCAA
ATGTTAGTAAATGCCAGAA -> TGTTAGTAAATGCCAGAAT
AACTCTGATCTAGATGATC -> ACTCTGATCTAGATGATCA
TATACGCAGATGATTAAAC -> ATACGCAGATGATTAAACA
CGCCATCGGAGGTATATTC -> GCCATCGGAGGTATATTCT
CGGAGACCACGTCGTGATC -> GGAGACCACGTCGTGATCC
CCCTATAACACTTCATTAG -> CCTATAACACTTCATTAGG
TGTAGACATAGCCAATACA -> GTAGACATAGCCAATACAC
CCATCGACTAATAGGGAGG -> CATCGACTAATAGGGAGGA
GTAGAATTGTAGACATAGC -> TAGAATTGTAGACATAGCC
GGCGGGCGCAATCCATTAT -> GCGGGCGCAATCCATTATG
GTCGGGGCACCCCAAGCAA -> TCGGGGCACCCCAAGCAAG
TAATTATGTTAATCGGCGC -> AATTATGTTAATCGGCGCC
GATATGATTGCTAACATCA -> ATATGATTGCTAACATCAA
TACCTATGGCGTACGGGAG -> ACCTATGGCGTACGGGAGT
GAGCAGAGACGCGTTTATA -> AGCAGAGACGCGTTTATAG
CTCTAGGGACGGTTAGTGC -> TCTAGGGACGGTTAGTGCC
TATTTAGATGGCCGTTGCA -> ATTTAGATGGCCGTTGCAC
AGGTCGTTCATGATGCTCA -> GGTCGTTCATGATGCTCAA
ACGGAGTAATGACAGTCTA -> CGGAGTAATGACAGTCTAC
TTCCAGTCGAGCAGAGACG -> TCCAGTCGAGCAGAGACGC
CGGGCAGAAGACCGGATCA -> GGGCAGAAGACCGGATCAA
AACTACACACCGACACTAA -> ACTACACACCGACACTAAT
CGAAAGACTCCACGTGAGC -> GAAAGACTCCACGTGAGCC
ATTAAACACCGGGTTATGT -> TTAAACACCGGGTTATGTC
GCAGACTCCTGAGGGGTAT -> CAGACTCCTGAGGGGTATG
CATCATTAGGATGCCACCA -> ATCATTAGGATGCCACCAC
CCGTTGTAATGATGTACCC -> CGTTGTAATGATGTACCCC
CTAATAGGGAGGACGAAAT -> TAATAGGGAGGACGAAATT
ATGAGGAATAGTCGTGTCC -> TGAGGAATAGTCGTGTCCC
AACACGAAGTGCCGAGCAT -> ACACGAAGTGCCGAGCATC
CCAGAAGAACAGTTGACAA -> CAGAAGAACAGTTGACAAA
TACGAGCCTATAAAGGTTC -> ACGAGCCTATAAAGGTTCT
AGTCGTGTCCCAGTCGGGG -> GTCGTGTCCCAGTCGGGGC
AGCATTCTAATAAAGCTAG -> GCATTCTAATAAAGCTAGG
GTCTCATGTGTTTCGGTGA -> TCTCATGTGTTTCGGTGAG
TCAGACCGTTGTAATGATG -> CAGACCGTTGTAATGATGT
TAAGATTGGTTCCAGGGAT -> AAGATTGGTTCCAGGGATC
CTGGTCTTGCGCAACTACA -> TGGTCTTGCGCAACTACAC
CAGACCGTTGTAATGATGT -> AGACCGTTGTAATGATGTA
TTTTCGTAGTTGGATCTCG -> TTTCGTAGTTGGATCTCGA
GTCCCCCTATTCCGCCAGA -> TCCCCCTATTCCGCCAGAA
AACTCTTAAAGGGCCTACA -> ACTCTTAAAGGGCCTACAA
CAATACCCGGACGGATACC -> AATACCCGGACGGATACCC
GGTTCCAGGGATCCAATTA -> GTTCCAGGGATCCAATTAC
GCATGTACATAAATACGGA -> CATGTACATAAATACGGAT
AAGAGCACGGCAGACTCCT -> AGAGCACGGCAGACTCCTG
TAATGTGTCATGAGATGAA -> AATGTGTCATGAGATGAAC
AGGATGCCACCACTTGTAA -> GGATGCCACCACTTGTAAG
TCTAGGGACGGTTAGTGCC -> CTAGGGACGGTTAGTGCCG
ATTCCTGCTTTGCTTATGC -> TTCCTGCTTTGCTTATGCC
TTCTTTCAGTAAAAATATC -> TCTTTCAGTAAAAATATCG
CAACTACACACCGACACTA -> AACTACACACCGACACTAA
ATCATAAAGCAGTACTAGC -> TCATAAAGCAGTACTAGCT
CAGCTCAGGAGTGGACAAA -> AGCTCAGGAGTGGACAAAG
TTCTAAATCGCGGGCAGAA -> TCTAAATCGCGGGCAGAAG
AGGTTCGAGCTAAGATTGG -> GGTTCGAGCTAAGATTGGT
GGTAGCAAACTCTGATCTA -> GTAGCAAACTCTGATCTAG
CGTAAGCGGAGACCACGTC -> GTAAGCGGAGACCACGTCG
ATATCGAATGTTAGTAAAT -> TATCGAATGTTAGTAAATG
TTATGTTAATCGGCGCCAC -> TATGTTAATCGGCGCCACT
GAGTCTATGTACTAGTGTA -> AGTCTATGTACTAGTGTAA
TCAGGAGTGGACAAAGATT -> CAGGAGTGGACAAAGATTT
CGGCCATCAGCCTGTTACC -> GGCCATCAGCCTGTTACCA
TGATTAAACACCGGGTTAT -> GATTAAACACCGGGTTATG
TAAATGGAGCATAGCGCAA -> AAATGGAGCATAGCGCAAC
CAACTGGAGGACCGCGGAC -> AACTGGAGGACCGCGGACA
CGGACAACAGGTCATGCGA -> GGACAACAGGTCATGCGAA
ACGCCATCGGAGGTATATT -> CGCCATCGGAGGTATATTC
GTAAATATGAACACCACGT -> TAAATATGAACACCACGTC
ATTGTAGACATAGCCAATA -> TTGTAGACATAGCCAATAC
ATTATGTTAATCGGCGCCA -> TTATGTTAATCGGCGCCAC
GTCGCGCGGCTTCGTAAAT -> TCGCGCGGCTTCGTAAATA
ATAAAGCAGTACTAGCTAT -> TAAAGCAGTACTAGCTATG
GCGCCACTTCGTGTCGGTG -> CGCCACTTCGTGTCGGTGC
TTAGTGCCGATCGGAATGT -> TAGTGCCGATCGGAATGTA
TGTCTACAAACCTAGTTAA -> GTCTACAAACCTAGTTAAT
GGGTATGGGAATTGTCTAC -> GGTATGGGAATTGTCTACA
GCCACCACGACGTTTGTTA -> CCACCACGACGTTTGTTAT
GGGTTATGTCGATGCCTGC -> GGTTATGTCGATGCCTGCG
GAGTGGACAAAGATTTAAG -> AGTGGACAAAGATTTAAGC
AAATCTCCCTACGCAAGGT -> AATCTCCCTACGCAAGGTC
TAAAACTCTTAAAGGGCCT -> AAAACTCTTAAAGGGCCTA
TCAAAGCGACGACACGATA -> CAAAGCGACGACACGATAC
CTCGATACCGTGTGCAATC -> TCGATACCGTGTGCAATCT
CCCTACGCAAGGTCGCGCG -> CCTACGCAAGGTCGCGCGG
AAACTCTTAAAGGGCCTAC -> AACTCTTAAAGGGCCTACA
GGAGGACCGCGGACAACAG -> GAGGACCGCGGACAACAGG
GGAGGTATATTCTTTCATA -> GAGGTATATTCTTTCATAT
AGCGCACCCATTACTACCT -> GCGCACCCATTACTACCTA
AGCAAGTGCAGTGTACTGT -> GCAAGTGCAGTGTACTGTC
ATATGGCGGTATGACTAGG -> TATGGCGGTATGACTAGGC
GTACTAGTGTAAAAATCTG -> TACTAGTGTAAAAATCTGT
AGTATTACGAGCCTATAAA -> GTATTACGAGCCTATAAAG
GCCACCACATGTGACGCCA -> CCACCACATGTGACGCCAT
ACTCTGATCTAGATGATCA -> CTCTGATCTAGATGATCAT
GGACGAAATTTAAATTCCT -> GACGAAATTTAAATTCCTG
TCAAAAGATCGTCTCAGTC -> CAAAAGATCGTCTCAGTCA
TTGCACTCCCCGGCCATCA -> TGCACTCCCCGGCCATCAG
AGTCGGGGCACCCCAAGCA -> GTCGGGGCACCCCAAGCAA
GGACCGCGGACAACAGGTC -> GACCGCGGACAACAGGTCA
GGTCGTTCATGATGCTCAA -> GTCGTTCATGATGCTCAAT
TACCGATCGGATTCCTAGT -> ACCGATCGGATTCCTAGTC
AAATGGAGCATAGCGCAAC -> AATGGAGCATAGCGCAACT
ATTGAGGTTCGAGCTAAGA -> TTGAGGTTCGAGCTAAGAT
GCATTCTAATAAAGCTAGG -> CATTCTAATAAAGCTAGGG
TGTGGAGTATAACGCAATT -> GTGGAGTATAACGCAATTA
CGCAACTGGAGGACCGCGG -> GCAACTGGAGGACCGCGGA
GGCCGTAATGTGTCATGAG -> GCCGTAATGTGTCATGAGA
TATGTCGATGCCTGCGTGT -> ATGTCGATGCCTGCGTGTG
TACAAACCTAGTTAATTAT -> ACAAACCTAGTTAATTATG
AATGTTAGTAAATGCCAGA -> ATGTTAGTAAATGCCAGAA
CGGAGGTATATTCTTTCAG -> GGAGGTATATTCTTTCAGT,GGAGGTATATTCTTTCAGC
GTAAATAAAGCTGGTCTTG -> TAAATAAAGCTGGTCTTGC
CCTAGATGAGGAATAGTCG -> CTAGATGAGGAATAGTCGT
AAGTGCAAACGTCAAAGCG -> AGTGCAAACGTCAAAGCGA
AATAGTACAACCAGAATAA -> ATAGTACAACCAGAATAAA
AGTAATGACAGTCTACCTG -> GTAATGACAGTCTACCTGC
CATCATATAACCCAAGCTC -> ATCATATAACCCAAGCTCT
TCTTTCATATGGCGGTATG -> CTTTCATATGGCGGTATGA
CTAAATCGCGGGCAGAAGA -> TAAATCGCGGGCAGAAGAC
AATACACTGTTTAACACAG -> ATACACTGTTTAACACAGA
AAAGCAGTACTAGCTATGC -> AAGCAGTACTAGCTATGCA
TCGGCACATGTACACAGTT -> CGGCACATGTACACAGTTC
GGAGGTATATTCTTTCAGT -> GAGGTATATTCTTTCAGTA
TTTCATATGGCGGTATGAC -> TTCATATGGCGGTATGACT
CAATGTGGAGTATAACGCA -> AATGTGGAGTATAACGCAA
TTACTTGGTTTGAACGCAC -> TACTTGGTTTGAACGCACT
GTCTCAGTCATTAGGATGC -> TCTCAGTCATTAGGATGCC
CCCCTGTCACAACCCTCGA -> CCCTGTCACAACCCTCGAT
AAGGGTCCCTGAGGAGTAT -> AGGGTCCCTGAGGAGTATA
TGTTACCACCTCTCGATAA -> GTTACCACCTCTCGATAAA
ACACACCGACACTAATTTA -> CACACCGACACTAATTTAA
TTAGACTACCTATGGCGTA -> TAGACTACCTATGGCGTAC
ACTCCCCGGCCATCAGCCT -> CTCCCCGGCCATCAGCCTG
GCTTTGATTAAGAGCTTCA -> CTTTGATTAAGAGCTTCAT
CCGATCGGATTCCTAGTCC -> CGATCGGATTCCTAGTCCC
ATGTACTAGTGTAAAAATC -> TGTACTAGTGTAAAAATCT
TCACAACCCTCGATACCGT -> CACAACCCTCGATACCGTG
ACAAGCTCTAGGGACGGTT -> CAAGCTCTAGGGACGGTTA
AAAGGTTCTGAAATAGTAC -> AAGGTTCTGAAATAGTACA
TCATTAGGATGCCACCACC -> CATTAGGATGCCACCACCA
ATTACCCCGAAAGACTCCA -> TTACCCCGAAAGACTCCAC
GCGCGGCTTCGTAAATATG -> CGCGGCTTCGTAAATATGA
TCGCATCATTAGGATGCCA -> CGCATCATTAGGATGCCAC
GTCAAAGCGACGACACGAT -> TCAAAGCGACGACACGATA
CGGGAGTGTGCATTTATAA -> GGGAGTGTGCATTTATAAG
CCCCGGCCATCAGCCTGTT -> CCCGGCCATCAGCCTGTTA
GCCTGCGTGTGGATATGAT -> CCTGCGTGTGGATATGATT
AGCGGAGACCACGTCGTGA -> GCGGAGACCACGTCGTGAT
CTTTATGGCCAATACCCGG -> TTTATGGCCAATACCCGGA
GGACGGATACCCGCCTGAC -> GACGGATACCCGCCTGACC
AGATCAGACCGTTGTAATG -> GATCAGACCGTTGTAATGA
ATGAGATGAACTGGTTCTA -> TGAGATGAACTGGTTCTAC
AAATTGAGGTTCGAGCTAA -> AATTGAGGTTCGAGCTAAG
ATTACTACCTACTTCTAAA -> TTACTACCTACTTCTAAAT
GTACGGGAGTGTGCATTTA -> TACGGGAGTGTGCATTTAT
AATCTTGCCGGCCCATCCA -> ATCTTGCCGGCCCATCCAT
ACAACTCTCCCTTGTCCGG -> CAACTCTCCCTTGTCCGGA
ACGAGCCTATAAAGGTTCT -> CGAGCCTATAAAGGTTCTG
TCTGCGGCAAAGCGTCCAC -> CTGCGGCAAAGCGTCCACT
CCTACGCAAGGTCGCGCGG -> CTACGCAAGGTCGCGCGGC
GCATTTATAAGCACGACAA -> CATTTATAAGCACGACAAT
CGACACCCCTAGATGAGGA -> GACACCCCTAGATGAGGAA
CTCATGTGTTTCGGTGAGG -> TCATGTGTTTCGGTGAGGT
GATGCTCAATGTGGAGTAT -> ATGCTCAATGTGGAGTATA
AACCTTACTTGGTTTGAAC -> ACCTTACTTGGTTTGAACG
GGTGAGCTGCCTTGGATCG -> GTGAGCTGCCTTGGATCGC
GCAAAGCGTCCACTCCGCG -> CAAAGCGTCCACTCCGCGT
CGGCTGTGGTCCATAATAT -> GGCTGTGGTCCATAATATC
GGCCGTTGCACTCCCCGGC -> GCCGTTGCACTCCCCGGCC
ATAAATACGGATGATTTAC -> TAAATACGGATGATTTACA
AGGTAAATGGAGCATAGCG -> GGTAAATGGAGCATAGCGC
AAGTTCTATTATTTTCCAG -> AGTTCTATTATTTTCCAGA
CTCACCCGGCTGTGGTCCA -> TCACCCGGCTGTGGTCCAT
TTAATTATGTTAATCGGCG -> TAATTATGTTAATCGGCGC
TACGCCCTAGAATAATAAG -> ACGCCCTAGAATAATAAGG
CTCCCTACGCAAGGTCGCG -> TCCCTACGCAAGGTCGCGC
GTCCCTTATACGCAGATGA -> TCCCTTATACGCAGATGAT
CAATCCATTATGTCTGTGA -> AATCCATTATGTCTGTGAG
GATTAAGAGCTTCATTACG -> ATTAAGAGCTTCATTACGG
GCCTGACCTTCCCTATAAC -> CCTGACCTTCCCTATAACA
GACGGATACCCGCCTGACC -> ACGGATACCCGCCTGACCT
CGACACTAATTTAAAAATA -> GACACTAATTTAAAAATAA
TCAATGTGGAGTATAACGC -> CAATGTGGAGTATAACGCA
ATCAGCCTGTTACCACCTC -> TCAGCCTGTTACCACCTCT
CTACTGGCGCCTGGTCTGC -> TACTGGCGCCTGGTCTGCG
GAAGAACAGTTGACAAACA -> AAGAACAGTTGACAAACAA
CCAATTACCCCGAAAGACT -> CAATTACCCCGAAAGACTC
ATCACTATAGATATGCATG -> TCACTATAGATATGCATGA
ACTCTTAAAGGGCCTACAA -> CTCTTAAAGGGCCTACAAC
ACTGGTTCTACTGGCGCCT -> CTGGTTCTACTGGCGCCTG
GATTGCTAACATCAAATCT -> ATTGCTAACATCAAATCTT
ATGCTCAATGTGGAGTATA -> TGCTCAATGTGGAGTATAA
TCAGTGTAAATAAAGCTGG -> CAGTGTAAATAAAGCTGGT
TTTAACACAGATCAGACCG -> TTAACACAGATCAGACCGT
AGAATTTTTCGTAGTTGGA -> GAATTTTTCGTAGTTGGAT
GCAAGTGCAGTGTACTGTC -> CAAGTGCAGTGTACTGTCC
TCCCTCGTCCCTTATACGC -> CCCTCGTCCCTTATACGCA
AGACTACCTATGGCGTACG -> GACTACCTATGGCGTACGG
TAGTAAATGCCAGAATTTT -> AGTAAATGCCAGAATTTTT
AGCACGGCAGACTCCTGAG -> GCACGGCAGACTCCTGAGG
ATCCCCGGATAAACGAGCT -> TCCCCGGATAAACGAGCTT
TCCGGATATCGGCACATGT -> CCGGATATCGGCACATGTA
TAGATGGCCGTTGCACTCC -> AGATGGCCGTTGCACTCCC
ATGCCTGCGTGTGGATATG -> TGCCTGCGTGTGGATATGA
TCCCCCTATTCCGCCAGAA -> CCCCCTATTCCGCCAGAAG
CCTCGATACCGTGTGCAAT -> CTCGATACCGTGTGCAATC
AGCTAAGATTGGTTCCAGG -> GCTAAGATTGGTTCCAGGG
GACGCGTTTATAGGTCGTT -> ACGCGTTTATAGGTCGTTC
TTTGATTAAGAGCTTCATT -> TTGATTAAGAGCTTCATTA
GAATAATAAGGATATAACC -> AATAATAAGGATATAACCT
TAAATTCCTGCTTTGCTTA -> AAATTCCTGCTTTGCTTAT
TATGAACACCACGTCACGC -> ATGAACACCACGTCACGCT
TAGACACAACTCCCTAGAA -> AGACACAACTCCCTAGAAA
GAGGACCGCGGACAACAGG -> AGGACCGCGGACAACAGGT
TGAGGTTCGAGCTAAGATT -> GAGGTTCGAGCTAAGATTG
AGTGCCGAGCATCATAATT -> GTGCCGAGCATCATAATTG
ACACCCCTAGATGAGGAAT -> CACCCCTAGATGAGGAATA
TTCTATTATTTTCCAGATA -> TCTATTATTTTCCAGATAG
TCCGCCAGAAGAACAGTTG -> CCGCCAGAAGAACAGTTGA
CTTCGTAAATATGAACACC -> TTCGTAAATATGAACACCA
TAGGCGGGCGCAATCCATT -> AGGCGGGCGCAATCCATTA
GAAAGACTCCACGTGAGCC -> AAAGACTCCACGTGAGCCC
GTTCCAGGGATCCAATTAC -> TTCCAGGGATCCAATTACC
TACCCCGAAAGACTCCACG -> ACCCCGAAAGACTCCACGT
TCCTACTATCCACGATAAA -> CCTACTATCCACGATAAAA
ACGTCACGCTCACCCGGCT -> CGTCACGCTCACCCGGCTG
CTTGTAAGGCGGTCGGAGG -> TTGTAAGGCGGTCGGAGGT
TTTCGGTGAGGTGAGCTGC -> TTCGGTGAGGTGAGCTGCC
TAAATATGAACACCACGTC -> AAATATGAACACCACGTCA
GGTATATTCTTTCATGCGG -> GTATATTCTTTCATGCGGC
CATCCATCGACTAATAGGG -> ATCCATCGACTAATAGGGA
CACGATAAAATTCTCATTA -> ACGATAAAATTCTCATTAG
TCATAAAGCAGTACTAGCT -> CATAAAGCAGTACTAGCTA
CGTGTGGATATGATTGCTA -> GTGTGGATATGATTGCTAA
GTACATAAATACGGATGAT -> TACATAAATACGGATGATT
GCCGCCATACTCGTAAGCG -> CCGCCATACTCGTAAGCGG
TTCTTTCATGCGGCGGGTA -> TCTTTCATGCGGCGGGTAT
CGTCGCTGGCAACATCCCC -> GTCGCTGGCAACATCCCCG
ATCTGTATTTTATCATACG -> TCTGTATTTTATCATACGT
GCTATGCAGGCCTAGGCAG -> CTATGCAGGCCTAGGCAGA
TGTACATAAATACGGATGA -> GTACATAAATACGGATGAT
CCTCGTCCCTTATACGCAG -> CTCGTCCCTTATACGCAGA
CCACTTCGTGTCGGTGCAT -> CACTTCGTGTCGGTGCATC
ATAACGCAATTATATCTGT -> TAACGCAATTATATCTGTC
TATAAAGGTTCTGAAATAG -> ATAAAGGTTCTGAAATAGT
GGATATCGGCACATGTACA -> GATATCGGCACATGTACAC
GTATGACTAGGCGGGCGCA -> TATGACTAGGCGGGCGCAA
TGCCTGCGTGTGGATATGA -> GCCTGCGTGTGGATATGAT
ACCTGATACGCTCTGTAAC -> CCTGATACGCTCTGTAACT
GCTGCCTTGGATCGCATCA -> CTGCCTTGGATCGCATCAT
TATCGAATGTTAGTAAATG -> ATCGAATGTTAGTAAATGC
ACACCGACACTAATTTAAA -> CACCGACACTAATTTAAAA
GAGGTATATTCTTTCAGTA -> AGGTATATTCTTTCAGTAA
TTACACGACACCCCTAGAT -> TACACGACACCCCTAGATG
GTCCCAGTCGGGGCACCCC -> TCCCAGTCGGGGCACCCCA
ACGGAGGCGTGAAGTTCTA -> CGGAGGCGTGAAGTTCTAT
CGGTATGACTAGGCGGGCG -> GGTATGACTAGGCGGGCGC
GTCGTGTCCCAGTCGGGGC -> TCGTGTCCCAGTCGGGGCA
AGGATATAACCTTACTTGG -> GGATATAACCTTACTTGGT
TGCGTGTGGATATGATTGC -> GCGTGTGGATATGATTGCT
CGATCGGAATGTAGCATTC -> GATCGGAATGTAGCATTCT
ATAGCGCAACTGGAGGACC -> TAGCGCAACTGGAGGACCG
ATACTCGTAAGCGGAGACC -> TACTCGTAAGCGGAGACCA
TTAGGATGCCACCACATGT -> TAGGATGCCACCACATGTG
CAACCAGAATAAAACTCTT -> AACCAGAATAAAACTCTTA
GGGCGCAATCCATTATGTC -> GGCGCAATCCATTATGTCT
ATACGGAGTAATGACAGTC -> TACGGAGTAATGACAGTCT
GAAAAAAGAGTTTACGCCC -> AAAAAAGAGTTTACGCCCT
TCCACGATAAAATTCTCAT -> CCACGATAAAATTCTCATT
GCAATCCATTATGTCTGTG -> CAATCCATTATGTCTGTGA
TCGGGGCACCCCAAGCAAG -> CGGGGCACCCCAAGCAAGT
AAGGTCGCGCGGCTTCGTA -> AGGTCGCGCGGCTTCGTAA
GTGCAATCTTCTCACTAAA -> TGCAATCTTCTCACTAAAC
AAGCGGAGACCACGTCGTG -> AGCGGAGACCACGTCGTGA
CGATGCCTGCGTGTGGATA -> GATGCCTGCGTGTGGATAT
GTCTGCGGCAAAGCGTCCA -> TCTGCGGCAAAGCGTCCAC
TACACACCGACACTAATTT -> ACACACCGACACTAATTTA
CTACTATCCACGATAAAAT -> TACTATCCACGATAAAATT
ATCGAATGTTAGTAAATGC -> TCGAATGTTAGTAAATGCC
CCTGTTACCACCTCTCGAT -> CTGTTACCACCTCTCGATA
CCAAGCAAGTGCAGTGTAC -> CAAGCAAGTGCAGTGTACT
TAAGGATATAACCTTACTT -> AAGGATATAACCTTACTTG
ATTTAAATTCCTGCTTTGC -> TTTAAATTCCTGCTTTGCT
GAGCTTTGATTAAGAGCTT -> AGCTTTGATTAAGAGCTTC
TATGCAGGCCTAGGCAGAG -> ATGCAGGCCTAGGCAGAGT
GAAGACCGGATCAAAAGAT -> AAGACCGGATCAAAAGATC
AATTCCTGCTTTGCTTATG -> ATTCCTGCTTTGCTTATGC
AGCTCTTCGTAAGCCTTTA -> GCTCTTCGTAAGCCTTTAT
CGAAATTGAGGTTCGAGCT -> GAAATTGAGGTTCGAGCTA
GGAATAGTCGTGTCCCAGT -> GAATAGTCGTGTCCCAGTC
TACAACCAGAATAAAACTC -> ACAACCAGAATAAAACTCT
CACTATAGATATGCATGAA -> ACTATAGATATGCATGAAC
CCTATAACACTTCATTAGG -> CTATAACACTTCATTAGGA
AATGTAGCATTCTAATAAA -> ATGTAGCATTCTAATAAAG
GCCATCAGCCTGTTACCAC -> CCATCAGCCTGTTACCACC
CCTATAAAGGTTCTGAAAT -> CTATAAAGGTTCTGAAATA
TACCCGGACGGATACCCGC -> ACCCGGACGGATACCCGCC
TGAGGAATAGTCGTGTCCC -> GAGGAATAGTCGTGTCCCA
AATTGAGGTTCGAGCTAAG -> ATTGAGGTTCGAGCTAAGA
TCCCTAGAAAAAAGAGTTT -> CCCTAGAAAAAAGAGTTTA
GTCCGGATATCGGCACATG -> TCCGGATATCGGCACATGT
GTGTAAAAATCTGTATTTT -> TGTAAAAATCTGTATTTTA
TTCATGCGGCGGGTATTTA -> TCATGCGGCGGGTATTTAG
AGCCTATAAAGGTTCTGAA -> GCCTATAAAGGTTCTGAAA
TATTCTTTCAGTAAAAATA -> ATTCTTTCAGTAAAAATAT
TATAACCCAAGCTCTTCGT -> ATAACCCAAGCTCTTCGTA
AAAGGGCCTACAACTCTCC -> AAGGGCCTACAACTCTCCC
AACACCACGTCACGCTCAC -> ACACCACGTCACGCTCACC
CCCGGATAAACGAGCTTTG -> CCGGATAAACGAGCTTTGA
AGTAAAAATATCGAATGTT -> GTAAAAATATCGAATGTTA
GAGGGGTATGGGAATTGTC -> AGGGGTATGGGAATTGTCT
GCGTGCAACCTGATACGCT -> CGTGCAACCTGATACGCTC
TCTGTAACTTTAATTTGGA -> CTGTAACTTTAATTTGGAC
GAACTCGACGGGCCGTAAT -> AACTCGACGGGCCGTAATG
TCGGAATGTAGCATTCTAA -> CGGAATGTAGCATTCTAAT
GAGCATCATAATTGCCGTC -> AGCATCATAATTGCCGTCG
ATTAGGATGCCACCACGAC -> TTAGGATGCCACCACGACG
TTTCGTAGTTGGATCTCGA -> TTCGTAGTTGGATCTCGAC
AACACTTCATTAGGATGCC -> ACACTTCATTAGGATGCCA
TCAAATCTTGCCGGCCCAT -> CAAATCTTGCCGGCCCATC
ACGAGCTTTGATTAAGAGC -> CGAGCTTTGATTAAGAGCT
CAGACTCCTGAGGGGTATG -> AGACTCCTGAGGGGTATGG
CATATAACCCAAGCTCTTC -> ATATAACCCAAGCTCTTCG
TCGATAAAGTATTACGAGC -> CGATAAAGTATTACGAGCC
CGTCCTATACTACCGATCG -> GTCCTATACTACCGATCGG
GCAGAGACGCGTTTATAGG -> CAGAGACGCGTTTATAGGT
GCCGATCGGAATGTAGCAT -> CCGATCGGAATGTAGCATT
TGATTTACACGACACCCCT -> GATTTACACGACACCCCTA
AACAGTTGACAAACAAGCT -> ACAGTTGACAAACAAGCTC
CACTAAATCTCCCTACGCA -> ACTAAATCTCCCTACGCAA
AGAATTGTAGACATAGCCA -> GAATTGTAGACATAGCCAA
TACCGTGTGCAATCTTCTC -> ACCGTGTGCAATCTTCTCA
GATCAGACCGTTGTAATGA -> ATCAGACCGTTGTAATGAT
AGATATGCATGAACACGAA -> GATATGCATGAACACGAAG
TAAAGCAGTACTAGCTATG -> AAAGCAGTACTAGCTATGC
CGCTGGCAACATCCCCGGA -> GCTGGCAACATCCCCGGAT
TTTATAGGTCGTTCATGAT -> TTATAGGTCGTTCATGATG
TACTAGTGTAAAAATCTGT -> ACTAGTGTAAAAATCTGTA
CTTCTAAATCGCGGGCAGA -> TTCTAAATCGCGGGCAGAA
GTATTTTATCATACGTTAG -> TATTTTATCATACGTTAGC
CCAGCTTTAAGCTCGGAGG -> CAGCTTTAAGCTCGGAGGT
TACCTGCGTAAAGGTAGAA -> ACCTGCGTAAAGGTAGAAT
GATCGCATCATTAGGATGC -> ATCGCATCATTAGGATGCC
AATTTGGACACCGCAGTTA -> ATTTGGACACCGCAGTTAT
GGGCACCCCAAGCAAGTGC -> GGCACCCCAAGCAAGTGCA
GCAGTACTAGCTATGCAGG -> CAGTACTAGCTATGCAGGC
CGGATTCCTAGTCCCCCTA -> GGATTCCTAGTCCCCCTAT
ATCAAAAGATCGTCTCAGT -> TCAAAAGATCGTCTCAGTC
TGCCAGAATTTTTCGTAGT -> GCCAGAATTTTTCGTAGTT
TCGTGTCGGTGCATCATAT -> CGTGTCGGTGCATCATATA
CTGATCTAGATGATCATAA -> TGATCTAGATGATCATAAA
ACTCCGCGTGCAACCTGAT -> CTCCGCGTGCAACCTGATA
TGCATTTATAAGCACGACA -> GCATTTATAAGCACGACAA
GTCATTAGGATGCCACCAC -> TCATTAGGATGCCACCACG
TATGTTAATCGGCGCCACT -> ATGTTAATCGGCGCCACTT
AACTCCCTAGAAAAAAGAG -> ACTCCCTAGAAAAAAGAGT
GGAGTATAATTCCCTCGTC -> GAGTATAATTCCCTCGTCC
GCTAACATCAAATCTTGCC -> CTAACATCAAATCTTGCCG
GACACGATACGGAGTAATG -> ACACGATACGGAGTAATGA
TCACCCGGCTGTGGTCCAT -> CACCCGGCTGTGGTCCATA
GGTAGAATTGTAGACATAG -> GTAGAATTGTAGACATAGC
TTTATGGCCAATACCCGGA -> TTATGGCCAATACCCGGAC
TTCCAGATAGTCTCATGTG -> TCCAGATAGTCTCATGTGT
GATGAGGAATAGTCGTGTC -> ATGAGGAATAGTCGTGTCC
ATCGCATCATTAGGATGCC -> TCGCATCATTAGGATGCCA
TGGAGCATAGCGCAACTGG -> GGAGCATAGCGCAACTGGA
AGGGTCCCTGAGGAGTATA -> GGGTCCCTGAGGAGTATAA
ATAATATCAGTGTAAATAA -> TAATATCAGTGTAAATAAA
AGGCGGGCGCAATCCATTA -> GGCGGGCGCAATCCATTAT
CTCAGGAGTGGACAAAGAT -> TCAGGAGTGGACAAAGATT
CGGACGGATACCCGCCTGA -> GGACGGATACCCGCCTGAC
GATAAAATTCTCATTAGGA -> ATAAAATTCTCATTAGGAT
CTAGAATAATAAGGATATA -> TAGAATAATAAGGATATAA
GCGGTATGACTAGGCGGGC -> CGGTATGACTAGGCGGGCG
ACGCATAGACACAACTCCC -> CGCATAGACACAACTCCCT
CGTTTATAGGTCGTTCATG -> GTTTATAGGTCGTTCATGA
GCGGGTATTTAGATGGCCG -> CGGGTATTTAGATGGCCGT
TACGCTCTGTAACTTTAAT -> ACGCTCTGTAACTTTAATT
CGGCCCATCCATCGACTAA -> GGCCCATCCATCGACTAAT
CACTTGTAAGGCGGTCGGA -> ACTTGTAAGGCGGTCGGAG
GCTTCGTAAATATGAACAC -> CTTCGTAAATATGAACACC
ACGTGAGCCCTTAGACTAC -> CGTGAGCCCTTAGACTACC
GGATCTCGACGCATAGACA -> GATCTCGACGCATAGACAC
ATGATGTACCCCCAAAGGG -> TGATGTACCCCCAAAGGGT
GATCGGATTCCTAGTCCCC -> ATCGGATTCCTAGTCCCCC
ACTTGGTTTGAACGCACTA -> CTTGGTTTGAACGCACTAA
ATTCCGCCAGAAGAACAGT -> TTCCGCCAGAAGAACAGTT
CCGTAATGTGTCATGAGAT -> CGTAATGTGTCATGAGATG
TCGAGCTAAGATTGGTTCC -> CGAGCTAAGATTGGTTCCA
CCTACTATCCACGATAAAA -> CTACTATCCACGATAAAAT
AAATATCGAATGTTAGTAA -> AATATCGAATGTTAGTAAA
CAACCTGATACGCTCTGTA -> AACCTGATACGCTCTGTAA
CTACCTACTTCTAAATCGC -> TACCTACTTCTAAATCGCG
GGGTCCCTGAGGAGTATAA -> GGTCCCTGAGGAGTATAAT
GTGTAAATAAAGCTGGTCT -> TGTAAATAAAGCTGGTCTT
CTAGATGATCATAAAGCAG -> TAGATGATCATAAAGCAGT
ACAAACCTAGTTAATTATG -> CAAACCTAGTTAATTATGT
ATAGGTCGTTCATGATGCT -> TAGGTCGTTCATGATGCTC
TTAAGCGCACCCATTACTA -> TAAGCGCACCCATTACTAC
AATATGAACACCACGTCAC -> ATATGAACACCACGTCACG
TCTACCTGCGTAAAGGTAG -> CTACCTGCGTAAAGGTAGA
CTCGACGCATAGACACAAC -> TCGACGCATAGACACAACT
GGATTCCTAGTCCCCCTAT -> GATTCCTAGTCCCCCTATT
CATTACGGAGGCGTGAAGT -> ATTACGGAGGCGTGAAGTT
GAGGTAAATGGAGCATAGC -> AGGTAAATGGAGCATAGCG
CGATAAAGTATTACGAGCC -> GATAAAGTATTACGAGCCT
GGAGTATAACGCAATTATA -> GAGTATAACGCAATTATAT
AGTGGACAAAGATTTAAGC -> GTGGACAAAGATTTAAGCG
CTACTTCTAAATCGCGGGC -> TACTTCTAAATCGCGGGCA
GGGACGGTTAGTGCCGATC -> GGACGGTTAGTGCCGATCG
CAGTGTACTGTCCTACTAT -> AGTGTACTGTCCTACTATC
GTAAAAATATCGAATGTTA -> TAAAAATATCGAATGTTAG
TTTGGACACCGCAGTTATA -> TTGGACACCGCAGTTATAA
CTACCGATCGGATTCCTAG -> TACCGATCGGATTCCTAGT
GTAAATGGAGCATAGCGCA -> TAAATGGAGCATAGCGCAA
GATGCCTGCGTGTGGATAT -> ATGCCTGCGTGTGGATATG
GTTAGCAGCATGTACATAA -> TTAGCAGCATGTACATAAA
TGTCCCAGTCGGGGCACCC -> GTCCCAGTCGGGGCACCCC
CCCCGGATAAACGAGCTTT -> CCCGGATAAACGAGCTTTG
ACGGGCCGTAATGTGTCAT -> CGGGCCGTAATGTGTCATG
ACTAGCTATGCAGGCCTAG -> CTAGCTATGCAGGCCTAGG
ATGGGAATTGTCTACAAAC -> TGGGAATTGTCTACAAACC
TCAGTAAAAATATCGAATG -> CAGTAAAAATATCGAATGT
CCTAGAAAAAAGAGTTTAC -> CTAGAAAAAAGAGTTTACG
GTTTGAACGCACTAAATCT -> TTTGAACGCACTAAATCTC
TTCGTGTCGGTGCATCATA -> TCGTGTCGGTGCATCATAT
CATCCCCGGATAAACGAGC -> ATCCCCGGATAAACGAGCT
AAAGACTCCACGTGAGCCC -> AAGACTCCACGTGAGCCCT
ATTTACACGACACCCCTAG -> TTTACACGACACCCCTAGA
GACGGGCCGTAATGTGTCA -> ACGGGCCGTAATGTGTCAT
TTAAATTCCTGCTTTGCTT -> TAAATTCCTGCTTTGCTTA
TTGCGCAACTACACACCGA -> TGCGCAACTACACACCGAC
TGTGGTCCATAATATCAGT -> GTGGTCCATAATATCAGTG
CTAATTTAAAAATAAATTG -> TAATTTAAAAATAAATTGA
ATATTCTTTCATGCGGCGG -> TATTCTTTCATGCGGCGGG
TACGGAGTAATGACAGTCT -> ACGGAGTAATGACAGTCTA
CCACCACATGTGACGCCAT -> CACCACATGTGACGCCATC
TGTTTCGGTGAGGTGAGCT -> GTTTCGGTGAGGTGAGCTG
TACTAGCTATGCAGGCCTA -> ACTAGCTATGCAGGCCTAG
TCATTAGGATGCCACCACT -> CATTAGGATGCCACCACTT
TAACATCAAATCTTGCCGG -> AACATCAAATCTTGCCGGC
CAAATCTTGCCGGCCCATC -> AAATCTTGCCGGCCCATCC
AGATGAACTGGTTCTACTG -> GATGAACTGGTTCTACTGG
GACTCCACGTGAGCCCTTA -> ACTCCACGTGAGCCCTTAG
TGATTGCTAACATCAAATC -> GATTGCTAACATCAAATCT
CCCGGCCATCAGCCTGTTA -> CCGGCCATCAGCCTGTTAC
TTCTGAAATAGTACAACCA -> TCTGAAATAGTACAACCAG
GCATGAACACGAAGTGCCG -> CATGAACACGAAGTGCCGA
TTGGTTCCAGGGATCCAAT -> TGGTTCCAGGGATCCAATT
TCGTAAGCGGAGACCACGT -> CGTAAGCGGAGACCACGTC
CGACTAATAGGGAGGACGA -> GACTAATAGGGAGGACGAA
GTCCCTGAGGAGTATAATT -> TCCCTGAGGAGTATAATTC
CGATACGGAGTAATGACAG -> GATACGGAGTAATGACAGT
TAATTTAAAAATAAATTGA -> AATTTAAAAATAAATTGAC
GCTTATGCCGCCATACTCG -> CTTATGCCGCCATACTCGT
TAAAGGTAGAATTGTAGAC -> AAAGGTAGAATTGTAGACA
GCTCTTCGTAAGCCTTTAT -> CTCTTCGTAAGCCTTTATG
CGCCTGACCTTCCCTATAA -> GCCTGACCTTCCCTATAAC
ATGACAGTCTACCTGCGTA -> TGACAGTCTACCTGCGTAA
AATTATATCTGTCCTTGAA -> ATTATATCTGTCCTTGAAT
TGCACTCCCCGGCCATCAG -> GCACTCCCCGGCCATCAGC
ATCCCCTGTCACAACCCTC -> TCCCCTGTCACAACCCTCG
CATAAAGCAGTACTAGCTA -> ATAAAGCAGTACTAGCTAT
ACTAGGCGGGCGCAATCCA -> CTAGGCGGGCGCAATCCAT
AAGAGCTTCATTACGGAGG -> AGAGCTTCATTACGGAGGC
CTACAACTCTCCCTTGTCC -> TACAACTCTCCCTTGTCCG
TTATGGCCAATACCCGGAC -> TATGGCCAATACCCGGACG
AGACCGTTGTAATGATGTA -> GACCGTTGTAATGATGTAC
TATGTACTAGTGTAAAAAT -> ATGTACTAGTGTAAAAATC
TCTCAGTCATTAGGATGCC -> CTCAGTCATTAGGATGCCA
GCGTAAAGGTAGAATTGTA -> CGTAAAGGTAGAATTGTAG
GCATCATAATTGCCGTCGC -> CATCATAATTGCCGTCGCT
ACTACACACCGACACTAAT -> CTACACACCGACACTAATT
CACGGCAGACTCCTGAGGG -> ACGGCAGACTCCTGAGGGG
AAACGAGCTTTGATTAAGA -> AACGAGCTTTGATTAAGAG
GGATATAACCTTACTTGGT -> GATATAACCTTACTTGGTT
AATATCAGTGTAAATAAAG -> ATATCAGTGTAAATAAAGC
TAAACGTCCTATACTACCG -> AAACGTCCTATACTACCGA
CTTATACGCAGATGATTAA -> TTATACGCAGATGATTAAA
CTCCCCGGCCATCAGCCTG -> TCCCCGGCCATCAGCCTGT
TAAGCGGAGACCACGTCGT -> AAGCGGAGACCACGTCGTG
GTCACAACCCTCGATACCG -> TCACAACCCTCGATACCGT
AAAGCTGGTCTTGCGCAAC -> AAGCTGGTCTTGCGCAACT
AAGATCGTCTCAGTCATTA -> AGATCGTCTCAGTCATTAG
ATCAATAGAGGTAAATGGA -> TCAATAGAGGTAAATGGAG
TGAGATGAACTGGTTCTAC -> GAGATGAACTGGTTCTACT
GCGTGAAGTTCTATTATTT -> CGTGAAGTTCTATTATTTT
CCTTGGATCGCATCATTAG -> CTTGGATCGCATCATTAGG
AGTCTATGTACTAGTGTAA -> GTCTATGTACTAGTGTAAA
AAGTGCCGAGCATCATAAT -> AGTGCCGAGCATCATAATT
ATGAACACGAAGTGCCGAG -> TGAACACGAAGTGCCGAGC
CATGTACACAGTTCTGGGC -> ATGTACACAGTTCTGGGCC
GTGATCCCCTGTCACAACC -> TGATCCCCTGTCACAACCC
CACGACGTTTGTTATCGGA -> ACGACGTTTGTTATCGGAG
TCTACTGGCGCCTGGTCTG -> CTACTGGCGCCTGGTCTGC
TCCCCGGCCATCAGCCTGT -> CCCCGGCCATCAGCCTGTT
CTAGGGTAGCAAACTCTGA -> TAGGGTAGCAAACTCTGAT
CGTGATCCCCTGTCACAAC -> GTGATCCCCTGTCACAACC
TTAATCGGCGCCACTTCGT -> TAATCGGCGCCACTTCGTG
CTATTCCGCCAGAAGAACA -> TATTCCGCCAGAAGAACAG
CTGCCTTGGATCGCATCAT -> TGCCTTGGATCGCATCATT
TTAGGATGCCACCACGACG -> TAGGATGCCACCACGACGT
CATAAATACGGATGATTTA -> ATAAATACGGATGATTTAC
TATTCTTTCAGCTCAGGAG -> ATTCTTTCAGCTCAGGAGT
AATGTGTCATGAGATGAAC -> ATGTGTCATGAGATGAACT
TGTAATGATGTACCCCCAA -> GTAATGATGTACCCCCAAA
GATTTAAGCGCACCCATTA -> ATTTAAGCGCACCCATTAC
ACTGGCGCCTGGTCTGCGG -> CTGGCGCCTGGTCTGCGGC
CCTACTTCTAAATCGCGGG -> CTACTTCTAAATCGCGGGC
AGCCCTTAGACTACCTATG -> GCCCTTAGACTACCTATGG
AAATTGACAAGAGCACGGC -> AATTGACAAGAGCACGGCA
GCAAGGTCGCGCGGCTTCG -> CAAGGTCGCGCGGCTTCGT
AAAGCTAGGGTAGCAAACT -> AAGCTAGGGTAGCAAACTC
GAGCTTCATTACGGAGGCG -> AGCTTCATTACGGAGGCGT
GTAGACATAGCCAATACAC -> TAGACATAGCCAATACACT
TGTTTAACACAGATCAGAC -> GTTTAACACAGATCAGACC
GCCAGAATTTTTCGTAGTT -> CCAGAATTTTTCGTAGTTG
CACATGTACACAGTTCTGG -> ACATGTACACAGTTCTGGG
TCCAGGGATCCAATTACCC -> CCAGGGATCCAATTACCCC
TTGAATCAATAGAGGTAAA -> TGAATCAATAGAGGTAAAT
TTTTATCATACGTTAGCAG -> TTTATCATACGTTAGCAGC
CTCTGTAACTTTAATTTGG -> TCTGTAACTTTAATTTGGA
AAAAATATCGAATGTTAGT -> AAAATATCGAATGTTAGTA
CAAAGCGACGACACGATAC -> AAAGCGACGACACGATACG
CATAATTGCCGTCGCTGGC -> ATAATTGCCGTCGCTGGCA
AAGATTTAAGCGCACCCAT -> AGATTTAAGCGCACCCATT
CGCAATTATATCTGTCCTT -> GCAATTATATCTGTCCTTG
CACTCCCCGGCCATCAGCC -> ACTCCCCGGCCATCAGCCT
ACCCCGAAAGACTCCACGT -> CCCCGAAAGACTCCACGTG
TCCTGCTTTGCTTATGCCG -> CCTGCTTTGCTTATGCCGC
CCCTCGATACCGTGTGCAA -> CCTCGATACCGTGTGCAAT
AATGACAGTCTACCTGCGT -> ATGACAGTCTACCTGCGTA
GACACTAATTTAAAAATAA -> ACACTAATTTAAAAATAAA
TTCCTGCTTTGCTTATGCC -> TCCTGCTTTGCTTATGCCG
GTGTCCCAGTCGGGGCACC -> TGTCCCAGTCGGGGCACCC
GCGGCGGGTATTTAGATGG -> CGGCGGGTATTTAGATGGC
TGTCCGGATATCGGCACAT -> GTCCGGATATCGGCACATG
AAAAGATCGTCTCAGTCAT -> AAAGATCGTCTCAGTCATT
CCCTTAGACTACCTATGGC -> CCTTAGACTACCTATGGCG
AAATGCCAGAATTTTTCGT -> AATGCCAGAATTTTTCGTA
GTCGTGATCCCCTGTCACA -> TCGTGATCCCCTGTCACAA
GCCGAGCATCATAATTGCC -> CCGAGCATCATAATTGCCG
ATACTACCGATCGGATTCC -> TACTACCGATCGGATTCCT
TATTACGAGCCTATAAAGG -> ATTACGAGCCTATAAAGGT
CCCTGAGGAGTATAATTCC -> CCTGAGGAGTATAATTCCC
CGTCGTGATCCCCTGTCAC -> GTCGTGATCCCCTGTCACA
GATCCCCTGTCACAACCCT -> ATCCCCTGTCACAACCCTC
CATGAGATGAACTGGTTCT -> ATGAGATGAACTGGTTCTA
ATCGGCGCCACTTCGTGTC -> TCGGCGCCACTTCGTGTCG
GATGATTAAACACCGGGTT -> ATGATTAAACACCGGGTTA
CCTTATACGCAGATGATTA -> CTTATACGCAGATGATTAA
CCATCGGAGGTATATTCTT -> CATCGGAGGTATATTCTTT
TGCCGATCGGAATGTAGCA -> GCCGATCGGAATGTAGCAT
TCGGATTCCTAGTCCCCCT -> CGGATTCCTAGTCCCCCTA
TACCCGCCTGACCTTCCCT -> ACCCGCCTGACCTTCCCTA
GGGGCACCCCAAGCAAGTG -> GGGCACCCCAAGCAAGTGC
AATAATAAGGATATAACCT -> ATAATAAGGATATAACCTT
TGTCCTACTATCCACGATA -> GTCCTACTATCCACGATAA
AGAGTTTACGCCCTAGAAT -> GAGTTTACGCCCTAGAATA
GACGAAATTTAAATTCCTG -> ACGAAATTTAAATTCCTGC
GAGGTATATTCTTTCATGC -> AGGTATATTCTTTCATGCG
ATTGGTTCCAGGGATCCAA -> TTGGTTCCAGGGATCCAAT
TAGCATTCTAATAAAGCTA -> AGCATTCTAATAAAGCTAG
CACTAAACGTCCTATACTA -> ACTAAACGTCCTATACTAC
ATATAACCTTACTTGGTTT -> TATAACCTTACTTGGTTTG
ATATTCTTTCATATGGCGG -> TATTCTTTCATATGGCGGT
AATATGTCGTGTAAGTGCA -> ATATGTCGTGTAAGTGCAA
CATACGTTAGCAGCATGTA -> ATACGTTAGCAGCATGTAC
AGATGAGGAATAGTCGTGT -> GATGAGGAATAGTCGTGTC
CATGCGGCGGGTATTTAGA -> ATGCGGCGGGTATTTAGAT
TTATCGGAGGTATATTCTT -> TATCGGAGGTATATTCTTT
GATGCCACCACATGTGACG -> ATGCCACCACATGTGACGC
CTTGTCCGGATATCGGCAC -> TTGTCCGGATATCGGCACA
GCCGTTGCACTCCCCGGCC -> CCGTTGCACTCCCCGGCCA
CTAGCTATGCAGGCCTAGG -> TAGCTATGCAGGCCTAGGC
TGTCGATGCCTGCGTGTGG -> GTCGATGCCTGCGTGTGGA
ACACCGCAGTTATAATATG -> CACCGCAGTTATAATATGT
TCCCTTATACGCAGATGAT -> CCCTTATACGCAGATGATT
ATTATATCTGTCCTTGAAT -> TTATATCTGTCCTTGAATC
ACGGTTAGTGCCGATCGGA -> CGGTTAGTGCCGATCGGAA
GACGGTTAGTGCCGATCGG -> ACGGTTAGTGCCGATCGGA
TGAACACCACGTCACGCTC -> GAACACCACGTCACGCTCA
ACAACAGGTCATGCGAAAT -> CAACAGGTCATGCGAAATT
TTGTAGACATAGCCAATAC -> TGTAGACATAGCCAATACA
GGGATCCAATTACCCCGAA -> GGATCCAATTACCCCGAAA
CCAGTCGAGCAGAGACGCG -> CAGTCGAGCAGAGACGCGT
TCATTACGGAGGCGTGAAG -> CATTACGGAGGCGTGAAGT
CTGGCGCCTGGTCTGCGGC -> TGGCGCCTGGTCTGCGGCA
CCCTAGAAAAAAGAGTTTA -> CCTAGAAAAAAGAGTTTAC
CGTAAGCCTTTATGGCCAA -> GTAAGCCTTTATGGCCAAT
GAACACCACGTCACGCTCA -> AACACCACGTCACGCTCAC
GGTTATGTCGATGCCTGCG -> GTTATGTCGATGCCTGCGT
AGCTTTAAGCTCGGAGGTA -> GCTTTAAGCTCGGAGGTAT
AATTGACAAGAGCACGGCA -> ATTGACAAGAGCACGGCAG
TGGAGTATAACGCAATTAT -> GGAGTATAACGCAATTATA
GCCAGAAGAACAGTTGACA -> CCAGAAGAACAGTTGACAA
ATGGCCGTTGCACTCCCCG -> TGGCCGTTGCACTCCCCGG
AGGTAGAATTGTAGACATA -> GGTAGAATTGTAGACATAG
GATACGGAGTAATGACAGT -> ATACGGAGTAATGACAGTC
AGGGAGGACGAAATTTAAA -> GGGAGGACGAAATTTAAAT
TGTGTCATGAGATGAACTG -> GTGTCATGAGATGAACTGG
GTCTACAAACCTAGTTAAT -> TCTACAAACCTAGTTAATT
TGAGGTGAGCTGCCTTGGA -> GAGGTGAGCTGCCTTGGAT
CCCAAGCTCTTCGTAAGCC -> CCAAGCTCTTCGTAAGCCT
GGGAGGACGAAATTTAAAT -> GGAGGACGAAATTTAAATT
TCCATTATGTCTGTGAGCT -> CCATTATGTCTGTGAGCTT
CTCCCTAGAAAAAAGAGTT -> TCCCTAGAAAAAAGAGTTT
AATCCATTATGTCTGTGAG -> ATCCATTATGTCTGTGAGC
GATCATAAAGCAGTACTAG -> ATCATAAAGCAGTACTAGC
GCTTTAAGCTCGGAGGTAT -> CTTTAAGCTCGGAGGTATA
TATAACACTTCATTAGGAT -> ATAACACTTCATTAGGATG
GGGGTATGGGAATTGTCTA -> GGGTATGGGAATTGTCTAC
AGTAAATGCCAGAATTTTT -> GTAAATGCCAGAATTTTTC
GCAGTGTACTGTCCTACTA -> CAGTGTACTGTCCTACTAT
ACATAAATACGGATGATTT -> CATAAATACGGATGATTTA
GATGCCACCACGACGTTTG -> ATGCCACCACGACGTTTGT
AATCGGCGCCACTTCGTGT -> ATCGGCGCCACTTCGTGTC
GGCCCATCCATCGACTAAT -> GCCCATCCATCGACTAATA
ATCGACTAATAGGGAGGAC -> TCGACTAATAGGGAGGACG
CGGGTATTTAGATGGCCGT -> GGGTATTTAGATGGCCGTT
TTAACACAGATCAGACCGT -> TAACACAGATCAGACCGTT
CTCGTAAGCGGAGACCACG -> TCGTAAGCGGAGACCACGT
AGGACGAAATTTAAATTCC -> GGACGAAATTTAAATTCCT
ATGTGTCATGAGATGAACT -> TGTGTCATGAGATGAACTG
AAATAAATTGACAAGAGCA -> AATAAATTGACAAGAGCAC
TCGTAAGCCTTTATGGCCA -> CGTAAGCCTTTATGGCCAA
GCAGAGTCTATGTACTAGT -> CAGAGTCTATGTACTAGTG
TCTTCGTAAGCCTTTATGG -> CTTCGTAAGCCTTTATGGC
CATGTGTTTCGGTGAGGTG -> ATGTGTTTCGGTGAGGTGA
ACTCCCTAGAAAAAAGAGT -> CTCCCTAGAAAAAAGAGTT
CCTGCGTGTGGATATGATT -> CTGCGTGTGGATATGATTG
GTGGATATGATTGCTAACA -> TGGATATGATTGCTAACAT
GCGTGTGGATATGATTGCT -> CGTGTGGATATGATTGCTA
CGGCTTCGTAAATATGAAC -> GGCTTCGTAAATATGAACA
GTCTGTGAGCTTCCAGTCG -> TCTGTGAGCTTCCAGTCGA
GGAGCATAGCGCAACTGGA -> GAGCATAGCGCAACTGGAG
GGATGCCACCACCAGCTTT -> GATGCCACCACCAGCTTTA
ACGCAGATGATTAAACACC -> CGCAGATGATTAAACACCG
ATATTCTTTCAGCTCAGGA -> TATTCTTTCAGCTCAGGAG
CGTACGGGAGTGTGCATTT -> GTACGGGAGTGTGCATTTA
CGCCCTAGAATAATAAGGA -> GCCCTAGAATAATAAGGAT
TCATGTGTTTCGGTGAGGT -> CATGTGTTTCGGTGAGGTG
AAATAGTACAACCAGAATA -> AATAGTACAACCAGAATAA
AACAGGTCATGCGAAATTG -> ACAGGTCATGCGAAATTGA
CCGATCGGAATGTAGCATT -> CGATCGGAATGTAGCATTC
TTTATCATACGTTAGCAGC -> TTATCATACGTTAGCAGCA
TATATTCTTTCAGTAAAAA -> ATATTCTTTCAGTAAAAAT
ACTAATTTAAAAATAAATT -> CTAATTTAAAAATAAATTG
GCAAACTCTGATCTAGATG -> CAAACTCTGATCTAGATGA
AATAGTCGTGTCCCAGTCG -> ATAGTCGTGTCCCAGTCGG
CACAACCCTCGATACCGTG -> ACAACCCTCGATACCGTGT
CGACAATCACTATAGATAT -> GACAATCACTATAGATATG
TGAGCCCTTAGACTACCTA -> GAGCCCTTAGACTACCTAT
CGAGCCTATAAAGGTTCTG -> GAGCCTATAAAGGTTCTGA
GACTAGGCGGGCGCAATCC -> ACTAGGCGGGCGCAATCCA
TGCGGCAAAGCGTCCACTC -> GCGGCAAAGCGTCCACTCC
ACATGTGACGCCATCGGAG -> CATGTGACGCCATCGGAGG
CGTAATGTGTCATGAGATG -> GTAATGTGTCATGAGATGA
AAGGATATAACCTTACTTG -> AGGATATAACCTTACTTGG
CGCAGATGATTAAACACCG -> GCAGATGATTAAACACCGG
CTTCTCACTAAACGTCCTA -> TTCTCACTAAACGTCCTAT
ACGCAAGGTCGCGCGGCTT -> CGCAAGGTCGCGCGGCTTC
TCTAATAAAGCTAGGGTAG -> CTAATAAAGCTAGGGTAGC
AGCATCATAATTGCCGTCG -> GCATCATAATTGCCGTCGC
TTGCCGGCCCATCCATCGA -> TGCCGGCCCATCCATCGAC
TCTGTCCTTGAATCAATAG -> CTGTCCTTGAATCAATAGA
TACGGGAGTGTGCATTTAT -> ACGGGAGTGTGCATTTATA
TAGCTATGCAGGCCTAGGC -> AGCTATGCAGGCCTAGGCA
TGACCTTCCCTATAACACT -> GACCTTCCCTATAACACTT
GACAACAGGTCATGCGAAA -> ACAACAGGTCATGCGAAAT
TACTATCCACGATAAAATT -> ACTATCCACGATAAAATTC
ACCGTTGTAATGATGTACC -> CCGTTGTAATGATGTACCC
TAGTGTAAAAATCTGTATT -> AGTGTAAAAATCTGTATTT
TGCGTAAAGGTAGAATTGT -> GCGTAAAGGTAGAATTGTA
TAAAGGTTCTGAAATAGTA -> AAAGGTTCTGAAATAGTAC
CTTCATTAGGATGCCACCA -> TTCATTAGGATGCCACCAC
TATATCTGTCCTTGAATCA -> ATATCTGTCCTTGAATCAA
GGTCCATAATATCAGTGTA -> GTCCATAATATCAGTGTAA
TGTGAGCTTCCAGTCGAGC -> GTGAGCTTCCAGTCGAGCA
ATGCCGCCATACTCGTAAG -> TGCCGCCATACTCGTAAGC
CACTGTTTAACACAGATCA -> ACTGTTTAACACAGATCAG
CCCTCGTCCCTTATACGCA -> CCTCGTCCCTTATACGCAG
GAGCATAGCGCAACTGGAG -> AGCATAGCGCAACTGGAGG
CCGGATCAAAAGATCGTCT -> CGGATCAAAAGATCGTCTC
TCGGTGAGGTGAGCTGCCT -> CGGTGAGGTGAGCTGCCTT
TATAAGCACGACAATCACT -> ATAAGCACGACAATCACTA
CTGCGGCAAAGCGTCCACT -> TGCGGCAAAGCGTCCACTC
CCGAAAGACTCCACGTGAG -> CGAAAGACTCCACGTGAGC
CAAAGGGTCCCTGAGGAGT -> AAAGGGTCCCTGAGGAGTA
AAACTCTGATCTAGATGAT -> AACTCTGATCTAGATGATC
ACTGGAGGACCGCGGACAA -> CTGGAGGACCGCGGACAAC
CCACTCCGCGTGCAACCTG -> CACTCCGCGTGCAACCTGA
GTAATGTGTCATGAGATGA -> TAATGTGTCATGAGATGAA
CCACGTGAGCCCTTAGACT -> CACGTGAGCCCTTAGACTA
CTTGGATCGCATCATTAGG -> TTGGATCGCATCATTAGGA
CGCAGTTATAATATGTCGT -> GCAGTTATAATATGTCGTG
CCAGAATAAAACTCTTAAA -> CAGAATAAAACTCTTAAAG
CACAACTCCCTAGAAAAAA -> ACAACTCCCTAGAAAAAAG
AGGTATATTCTTTCAGTAA -> GGTATATTCTTTCAGTAAA
ACTATCCACGATAAAATTC -> CTATCCACGATAAAATTCT
TCATAATTGCCGTCGCTGG -> CATAATTGCCGTCGCTGGC
CCAGTCGGGGCACCCCAAG -> CAGTCGGGGCACCCCAAGC
CAGCATGTACATAAATACG -> AGCATGTACATAAATACGG
AAAATTCTCATTAGGATGC -> AAATTCTCATTAGGATGCC
CCCCCAAAGGGTCCCTGAG -> CCCCAAAGGGTCCCTGAGG
ATTCTTTCATATGGCGGTA -> TTCTTTCATATGGCGGTAT
ACTACCTACTTCTAAATCG -> CTACCTACTTCTAAATCGC
TAATATCAGTGTAAATAAA -> AATATCAGTGTAAATAAAG
TGTCTGTGAGCTTCCAGTC -> GTCTGTGAGCTTCCAGTCG
AGACTCCTGAGGGGTATGG -> GACTCCTGAGGGGTATGGG
TATGGCCAATACCCGGACG -> ATGGCCAATACCCGGACGG
AGTTGACAAACAAGCTCTA -> GTTGACAAACAAGCTCTAG
CGGGGCACCCCAAGCAAGT -> GGGGCACCCCAAGCAAGTG
GAGTAATGACAGTCTACCT -> AGTAATGACAGTCTACCTG
TGAACGCACTAAATCTCCC -> GAACGCACTAAATCTCCCT
TTGATTAAGAGCTTCATTA -> TGATTAAGAGCTTCATTAC
GATGATCATAAAGCAGTAC -> ATGATCATAAAGCAGTACT
CGATACCGTGTGCAATCTT -> GATACCGTGTGCAATCTTC
TGTGCATTTATAAGCACGA -> GTGCATTTATAAGCACGAC
CATTAGGATGCCACCACCA -> ATTAGGATGCCACCACCAG
CCCATTACTACCTACTTCT -> CCATTACTACCTACTTCTA
ATAAAGTATTACGAGCCTA -> TAAAGTATTACGAGCCTAT
AACGAGCTTTGATTAAGAG -> ACGAGCTTTGATTAAGAGC
TAATAAAGCTAGGGTAGCA -> AATAAAGCTAGGGTAGCAA
AGTCCCCCTATTCCGCCAG -> GTCCCCCTATTCCGCCAGA
CGCACCCATTACTACCTAC -> GCACCCATTACTACCTACT
GTTATCGGAGGTATATTCT -> TTATCGGAGGTATATTCTT
TGTCGGTGCATCATATAAC -> GTCGGTGCATCATATAACC
GACAAACAAGCTCTAGGGA -> ACAAACAAGCTCTAGGGAC
GGACGGTTAGTGCCGATCG -> GACGGTTAGTGCCGATCGG
ATGTACCCCCAAAGGGTCC -> TGTACCCCCAAAGGGTCCC