ACGGAGTTACCATTGTAGTC -> CGGAGTTACCATTGTAGTCG
AAGCCCGTGGTCTCATTTTA -> AGCCCGTGGTCTCATTTTAT
GGTTTTTATCCCTCTCATCC -> GTTTTTATCCCTCTCATCCT
TTGGTTTTTATCCCTCTCAT -> TGGTTTTTATCCCTCTCATC
ATGCCCACCTAAGTAGCAGC -> TGCCCACCTAAGTAGCAGCG
CGGCGGGTCGATTTTACCTG -> GGCGGGTCGATTTTACCTGT
CCTACTGGCACGCGTGGGGC -> CTACTGGCACGCGTGGGGCA
CAAAATAAGAAGCATAGCCA -> AAAATAAGAAGCATAGCCAT
AGACAGGCGTAATCTCCTTG -> GACAGGCGTAATCTCCTTGC
CTTAGACACGGCAAATTCCT -> TTAGACACGGCAAATTCCTC
TTTATCCCTCTCATCCTACC -> TTATCCCTCTCATCCTACCC
CAGATGAACAGAAGACAGAT -> AGATGAACAGAAGACAGATA
GCTGTAAGCGTGGTAACCTG -> CTGTAAGCGTGGTAACCTGA
ATCACGGCCAGGCTTACGAT -> TCACGGCCAGGCTTACGATC
GTGAAATTAATGTTTCAAAT -> TGAAATTAATGTTTCAAATA
TTCCGATTCTTAGACAGGCG -> TCCGATTCTTAGACAGGCGT
GTGGCAGATGAACAGAAGAC -> TGGCAGATGAACAGAAGACA
GGCGGGTCGATTTTACCTGT -> GCGGGTCGATTTTACCTGTA
TGTTTCAAATATTTAGCATC -> GTTTCAAATATTTAGCATCA
TATTTAGCATCAATAGAGGA -> ATTTAGCATCAATAGAGGAT
CGCACGTCGCGTACTAGGTT -> GCACGTCGCGTACTAGGTTC
CGATTCTTAGACAGGCGTAA -> GATTCTTAGACAGGCGTAAT
TTGCCACGTGGCGTGGCAGA -> TGCCACGTGGCGTGGCAGAT
CCCAGGTCTTGGTTTTTATC -> CCAGGTCTTGGTTTTTATCC
GCGATCCAACCACGTATGAA -> CGATCCAACCACGTATGAAT
ATATAGAGGACAGCCTTGTA -> TATAGAGGACAGCCTTGTAC
GGGACTATCACTGACGTTCT -> GGACTATCACTGACGTTCTG
GAGTTACCATTGTAGTCGAG -> AGTTACCATTGTAGTCGAGG
CAAGTGAATAACCCCTCGAG -> AAGTGAATAACCCCTCGAGT
AGCTGGTAGGTAGGCGTCAT -> GCTGGTAGGTAGGCGTCATA
GCACGGCACGCCTTGCGTGT -> CACGGCACGCCTTGCGTGTG
GTATGACGGCGGGTCGATTT -> TATGACGGCGGGTCGATTTT
AGCGTTGACCCGTAAGGACT -> GCGTTGACCCGTAAGGACTC
GGGTCGATTTTACCTGTAGC -> GGTCGATTTTACCTGTAGCA
TTATCCTTAGACACGGCAAA -> TATCCTTAGACACGGCAAAT
CCATATACCTATAGACAGGC -> CATATACCTATAGACAGGCT
GACTATCACTGACGTTCTGC -> ACTATCACTGACGTTCTGCC
CCCGTGGTCTCATTTTATGT -> CCGTGGTCTCATTTTATGTT
CGTCCGGATCACGTACGCGT -> GTCCGGATCACGTACGCGTA
ATGCAGTTCGATGGCGGCAA -> TGCAGTTCGATGGCGGCAAA
GACTCAACGCCTGAAAAGCT -> ACTCAACGCCTGAAAAGCTG
TTCTGCCACGACCAATAGTG -> TCTGCCACGACCAATAGTGA
GGCGGCAAACTTGCCGCTCG -> GCGGCAAACTTGCCGCTCGT
GTTCGATGGCGGCAAACTTG -> TTCGATGGCGGCAAACTTGC
TGCTGTAAGCGTGGTAACCT -> GCTGTAAGCGTGGTAACCTG
GTCCGTACGGTTGCCACGTG -> TCCGTACGGTTGCCACGTGG
ATGGCTTTTCCTCAATGCAG -> TGGCTTTTCCTCAATGCAGT
ACACAGATCTTCTGGAAATG -> CACAGATCTTCTGGAAATGT
AGTCTTACGTCCGGATCACG -> GTCTTACGTCCGGATCACGT
CTCGGGACTATCACTGACGT -> TCGGGACTATCACTGACGTT
AAAATAAGAAGCATAGCCAT -> AAATAAGAAGCATAGCCATA
ACTCAACGCCTGAAAAGCTG -> CTCAACGCCTGAAAAGCTGG
AGAAGACAGATAACTAGGTG -> GAAGACAGATAACTAGGTGT
CGTGGGGCATTAAGCCCGTG -> GTGGGGCATTAAGCCCGTGG
CGTGGTCTCATTTTATGTTT -> GTGGTCTCATTTTATGTTTT
GTCGCGTACTAGGTTCCAGG -> TCGCGTACTAGGTTCCAGGA
ACTTGGCGCCTGGGGGGCTT -> CTTGGCGCCTGGGGGGCTTA
GGCGTAATCTCCTTGCCTAC -> GCGTAATCTCCTTGCCTACT
GGCACGCCAGTCTACAAGAA -> GCACGCCAGTCTACAAGAAT
AGACACGGCAAATTCCTCGG -> GACACGGCAAATTCCTCGGG
GACGGCGGGTCGATTTTACC -> ACGGCGGGTCGATTTTACCT
CTGGCACGCGTGGGGCATTA -> TGGCACGCGTGGGGCATTAA
GAGCCCAATGCGATCCAACC -> AGCCCAATGCGATCCAACCA
CAGATAACTAGGTGTGCCCA -> AGATAACTAGGTGTGCCCAT
CCGTAAGGACTCAACGCCTG -> CGTAAGGACTCAACGCCTGA
GTACCAAGTGAATAACCCCT -> TACCAAGTGAATAACCCCTC
CATATACCTATAGACAGGCT -> ATATACCTATAGACAGGCTT
ACCCAGGTCTTGGTTTTTAT -> CCCAGGTCTTGGTTTTTATC
CTTATCCTTAGACACGGCAA -> TTATCCTTAGACACGGCAAA
GCGCTGGGGTACATAAGGCA -> CGCTGGGGTACATAAGGCAC
CGTCTAGCGTTGACCCGTAA -> GTCTAGCGTTGACCCGTAAG
CACATGGCCGCGCTCATCGC -> ACATGGCCGCGCTCATCGCT
CTCACGCCCCATGCTGTAAG -> TCACGCCCCATGCTGTAAGC
GACAGCCTTGTACGCCATAT -> ACAGCCTTGTACGCCATATA
CGAGATGACATTTTATAGTC -> GAGATGACATTTTATAGTCC
TAACGTACCAAGTGAATAAC -> AACGTACCAAGTGAATAACC
GTTTCCGATTCTTAGACAGG -> TTTCCGATTCTTAGACAGGC
GACGTTCTGCCACGACCAAT -> ACGTTCTGCCACGACCAATA
CGCCTGAAAAGCTGGTAGGT -> GCCTGAAAAGCTGGTAGGTA
GCGTATGACGGCGGGTCGAT -> CGTATGACGGCGGGTCGATT
AGAGGACAGCCTTGTACGCC -> GAGGACAGCCTTGTACGCCA
TTGGCGCCTGGGGGGCTTAC -> TGGCGCCTGGGGGGCTTACG
TTTACCTGTAGCAATACACG -> TTACCTGTAGCAATACACGA
TCGTCTAGCGTTGACCCGTA -> CGTCTAGCGTTGACCCGTAA
TACTAGGTTCCAGGACTTAT -> ACTAGGTTCCAGGACTTATG
GGTACATAAGGCACGCCAGT -> GTACATAAGGCACGCCAGTC
CGCTCATCGCTAACATAACG -> GCTCATCGCTAACATAACGT
ATAGACAGGCTTATCCTTAG -> TAGACAGGCTTATCCTTAGA
CGTACCAAGTGAATAACCCC -> GTACCAAGTGAATAACCCCT
TTTCCCGCACGGCACGCCTT -> TTCCCGCACGGCACGCCTTG
ACGTGGCGTGGCAGATGAAC -> CGTGGCGTGGCAGATGAACA
ACGCCTTGCGTGTGGGTCAA -> CGCCTTGCGTGTGGGTCAAC
ATGACGGCGGGTCGATTTTA -> TGACGGCGGGTCGATTTTAC
AGGACTCAACGCCTGAAAAG -> GGACTCAACGCCTGAAAAGC
GGGGGGCTTACGCATTCTTA -> GGGGGCTTACGCATTCTTAC
TATCACTGACGTTCTGCCAC -> ATCACTGACGTTCTGCCACG
ACCTGTAGCAATACACGACT -> CCTGTAGCAATACACGACTT
TAGAGGACAGCCTTGTACGC -> AGAGGACAGCCTTGTACGCC
ATGGCCGCGCTCATCGCTAA -> TGGCCGCGCTCATCGCTAAC
AGTTTCCGATTCTTAGACAG -> GTTTCCGATTCTTAGACAGG
CCTTAGACACGGCAAATTCC -> CTTAGACACGGCAAATTCCT
AAGTGAATAACCCCTCGAGT -> AGTGAATAACCCCTCGAGTA
ACTTGCCGCTCGTCTAGCGT -> CTTGCCGCTCGTCTAGCGTT
GATCCAACCACGTATGAATG -> ATCCAACCACGTATGAATGC
TTAGACAGGCGTAATCTCCT -> TAGACAGGCGTAATCTCCTT
CGTTTCCCGCACGGCACGCC -> GTTTCCCGCACGGCACGCCT
TTATCCCTCTCATCCTACCC -> TATCCCTCTCATCCTACCCC
CAGTTCGATGGCGGCAAACT -> AGTTCGATGGCGGCAAACTT
CGTACGCGTATGACGGCGGG -> GTACGCGTATGACGGCGGGT
TCGCTAACATAACGTACCAA -> CGCTAACATAACGTACCAAG
TAAGAAGCATAGCCATACGG -> AAGAAGCATAGCCATACGGA
TACTGCACATGGCCGCGCTC -> ACTGCACATGGCCGCGCTCA
CGACCAATAGTGACACAGAT -> GACCAATAGTGACACAGATC
TACGGAGTTACCATTGTAGT -> ACGGAGTTACCATTGTAGTC
AGCAGCGCTGGGGTACATAA -> GCAGCGCTGGGGTACATAAG
GCATAGCCATACGGAGTTAC -> CATAGCCATACGGAGTTACC
GCAGTTTCCGATTCTTAGAC -> CAGTTTCCGATTCTTAGACA
AGGCGTAATCTCCTTGCCTA -> GGCGTAATCTCCTTGCCTAC
AACGGTGAAATTAATGTTTC -> ACGGTGAAATTAATGTTTCA
CAATCACGGCCAGGCTTACG -> AATCACGGCCAGGCTTACGA
TTAATGTTTCAAATATTTAG -> TAATGTTTCAAATATTTAGC
GGCCAGGCTTACGATCACAG -> GCCAGGCTTACGATCACAGC
TCCGTACGGTTGCCACGTGG -> CCGTACGGTTGCCACGTGGC
ATCACTGACGTTCTGCCACG -> TCACTGACGTTCTGCCACGA
GTTGCCACGTGGCGTGGCAG -> TTGCCACGTGGCGTGGCAGA
GGTGTGCCCATGGCTTTTCC -> GTGTGCCCATGGCTTTTCCT
TAGGTTCCAGGACTTATGCC -> AGGTTCCAGGACTTATGCCG
CCACGACCAATAGTGACACA -> CACGACCAATAGTGACACAG
GACCCGTAAGGACTCAACGC -> ACCCGTAAGGACTCAACGCC
TTACGATCACAGCAGTTTCC -> TACGATCACAGCAGTTTCCG
CTCGCGCGCTACATTCTCAC -> TCGCGCGCTACATTCTCACG
GGCCGACCCAGGTCTTGGTT -> GCCGACCCAGGTCTTGGTTT
AATCTCCTTGCCTACTGGCA -> ATCTCCTTGCCTACTGGCAC
GATCACGTACGCGTATGACG -> ATCACGTACGCGTATGACGG
AGCCTTGTACGCCATATACC -> GCCTTGTACGCCATATACCT
TTCCAGGACTTATGCCGGAT -> TCCAGGACTTATGCCGGATA
GTTGACCCGTAAGGACTCAA -> TTGACCCGTAAGGACTCAAC
TTTTATGTTTTCATATAGAG -> TTTATGTTTTCATATAGAGG
TACATAAGGCACGCCAGTCT -> ACATAAGGCACGCCAGTCTA
TAGACAGGCTTATCCTTAGA -> AGACAGGCTTATCCTTAGAC
CGATCCAACCACGTATGAAT -> GATCCAACCACGTATGAATG
AAAAGCTGGTAGGTAGGCGT -> AAAGCTGGTAGGTAGGCGTC
CGCTAACATAACGTACCAAG -> GCTAACATAACGTACCAAGT
GCCATACGGAGTTACCATTG -> CCATACGGAGTTACCATTGT
CATAAGGCACGCCAGTCTAC -> ATAAGGCACGCCAGTCTACA
GCGTGTGGGTCAACGGTGAA -> CGTGTGGGTCAACGGTGAAA
GACCAATAGTGACACAGATC -> ACCAATAGTGACACAGATCT
TATCGGCTCGCGCGCTACAT -> ATCGGCTCGCGCGCTACATT
CCGACCCAGGTCTTGGTTTT -> CGACCCAGGTCTTGGTTTTT
GGTCGAGATGACATTTTATA -> GTCGAGATGACATTTTATAG
TGTCCAAAATAAGAAGCATA -> GTCCAAAATAAGAAGCATAG
GCTATCGGCTCGCGCGCTAC -> CTATCGGCTCGCGCGCTACA
TTTCAAATATTTAGCATCAA -> TTCAAATATTTAGCATCAAT
TCGATTTTACCTGTAGCAAT -> CGATTTTACCTGTAGCAATA
CGTGGTAACCTGACAATCAC -> GTGGTAACCTGACAATCACG
AGCGTGGTAACCTGACAATC -> GCGTGGTAACCTGACAATCA
ACGTACGCGTATGACGGCGG -> CGTACGCGTATGACGGCGGG
TCCTACCATCTAGAATGGTC -> CCTACCATCTAGAATGGTCC
CTGTAGCAATACACGACTTG -> TGTAGCAATACACGACTTGG
AATTGGATGGCGGCTATCGG -> ATTGGATGGCGGCTATCGGC
GTTTTCATATAGAGGACAGC -> TTTTCATATAGAGGACAGCC
TCGAGGGTCGAGATGACATT -> CGAGGGTCGAGATGACATTT
AGTGGCCCCGTTTCCCGCAC -> GTGGCCCCGTTTCCCGCACG
TCCTTGCCTACTGGCACGCG -> CCTTGCCTACTGGCACGCGT
ACCTATAGACAGGCTTATCC -> CCTATAGACAGGCTTATCCT
GATAACTAGGTGTGCCCATG -> ATAACTAGGTGTGCCCATGG
TTCTTACTGCACATGGCCGC -> TCTTACTGCACATGGCCGCG
TAAGTAGCAGCGCTGGGGTA -> AAGTAGCAGCGCTGGGGTAC
CAATAGTGACACAGATCTTC -> AATAGTGACACAGATCTTCT
GTACGGTTGCCACGTGGCGT -> TACGGTTGCCACGTGGCGTG
CTCATCCTACCCCTTCTGTT -> TCATCCTACCCCTTCTGTTG
AATGCGATCCAACCACGTAT -> ATGCGATCCAACCACGTATG
CGTATGACGGCGGGTCGATT -> GTATGACGGCGGGTCGATTT
CACTGACGTTCTGCCACGAC -> ACTGACGTTCTGCCACGACC
ATAGAGGACAGCCTTGTACG -> TAGAGGACAGCCTTGTACGC
TGCCACGTGGCGTGGCAGAT -> GCCACGTGGCGTGGCAGATG
CTGTAAGCGTGGTAACCTGA -> TGTAAGCGTGGTAACCTGAC
TGCAGTTCGATGGCGGCAAA -> GCAGTTCGATGGCGGCAAAC
GGCCCCGTTTCCCGCACGGC -> GCCCCGTTTCCCGCACGGCA
GTGTGCCCATGGCTTTTCCT -> TGTGCCCATGGCTTTTCCTC
GCGCTACATTCTCACGCCCC -> CGCTACATTCTCACGCCCCA
GTACATAAGGCACGCCAGTC -> TACATAAGGCACGCCAGTCT
CGGCTATCGGCTCGCGCGCT -> GGCTATCGGCTCGCGCGCTA
AAATTCCTCGGGACTATCAC -> AATTCCTCGGGACTATCACT
CCAGGCTTACGATCACAGCA -> CAGGCTTACGATCACAGCAG
GAATGGTCCGTACGGTTGCC -> AATGGTCCGTACGGTTGCCA
AATTAATGTTTCAAATATTT -> ATTAATGTTTCAAATATTTA
TCGCGCGCTACATTCTCACG -> CGCGCGCTACATTCTCACGC
CAACCACGTATGAATGCCCA -> AACCACGTATGAATGCCCAC
ACATAACGTACCAAGTGAAT -> CATAACGTACCAAGTGAATA
ACGCCTGAAAAGCTGGTAGG -> CGCCTGAAAAGCTGGTAGGT
AGGCACGCCAGTCTACAAGA -> GGCACGCCAGTCTACAAGAA
TTGCCTACTGGCACGCGTGG -> TGCCTACTGGCACGCGTGGG
AGCGCTGGGGTACATAAGGC -> GCGCTGGGGTACATAAGGCA
ATGAACAGAAGACAGATAAC -> TGAACAGAAGACAGATAACT
CATCAATAGAGGATGTAGAG -> ATCAATAGAGGATGTAGAGG
ATGCGATCCAACCACGTATG -> TGCGATCCAACCACGTATGA
AAACGCACGTCGCGTACTAG -> AACGCACGTCGCGTACTAGG
CAGGACTTATGCCGGATACG -> AGGACTTATGCCGGATACGG
GTAACCTGACAATCACGGCC -> TAACCTGACAATCACGGCCA
ACACGACTTGGCGCCTGGGG -> CACGACTTGGCGCCTGGGGG
GGAAATGTCCAAAATAAGAA -> GAAATGTCCAAAATAAGAAG
GATGGCGGCAAACTTGCCGC -> ATGGCGGCAAACTTGCCGCT
AAGCGTGGTAACCTGACAAT -> AGCGTGGTAACCTGACAATC
CCCCGTTTCCCGCACGGCAC -> CCCGTTTCCCGCACGGCACG
TACAAGAATCATTCGTAAGC -> ACAAGAATCATTCGTAAGCT
TCTGTTGAGCCCAATGCGAT -> CTGTTGAGCCCAATGCGATC
TCTAGCGTTGACCCGTAAGG -> CTAGCGTTGACCCGTAAGGA
TCAATAGAGGATGTAGAGGC -> CAATAGAGGATGTAGAGGCT
ACAATCACGGCCAGGCTTAC -> CAATCACGGCCAGGCTTACG
GTACTAGGTTCCAGGACTTA -> TACTAGGTTCCAGGACTTAT
CCTGTAGCAATACACGACTT -> CTGTAGCAATACACGACTTG
AAGCTGTAGTCTTACGTCCG -> AGCTGTAGTCTTACGTCCGG
TCAACGGTGAAATTAATGTT -> CAACGGTGAAATTAATGTTT
TGGATGGCGGCTATCGGCTC -> GGATGGCGGCTATCGGCTCG
AAGAAGCATAGCCATACGGA -> AGAAGCATAGCCATACGGAG
CACGCCTTGCGTGTGGGTCA -> ACGCCTTGCGTGTGGGTCAA
TTCAAATATTTAGCATCAAT -> TCAAATATTTAGCATCAATA
GGCAGATGAACAGAAGACAG -> GCAGATGAACAGAAGACAGA
AGCGACAATTGGATGGCGGC -> GCGACAATTGGATGGCGGCT
GGCGCCTGGGGGGCTTACGC -> GCGCCTGGGGGGCTTACGCA
TGCCTACTGGCACGCGTGGG -> GCCTACTGGCACGCGTGGGG
TCACAGCAGTTTCCGATTCT -> CACAGCAGTTTCCGATTCTT
TAGAATGGTCCGTACGGTTG -> AGAATGGTCCGTACGGTTGC
TAACTAGGTGTGCCCATGGC -> AACTAGGTGTGCCCATGGCT
CGCGTACTAGGTTCCAGGAC -> GCGTACTAGGTTCCAGGACT
GAGCGACAATTGGATGGCGG -> AGCGACAATTGGATGGCGGC
CGGCTCGCGCGCTACATTCT -> GGCTCGCGCGCTACATTCTC
ACAGATCTTCTGGAAATGTC -> CAGATCTTCTGGAAATGTCC
GATTTTACCTGTAGCAATAC -> ATTTTACCTGTAGCAATACA
TGGAAATGTCCAAAATAAGA -> GGAAATGTCCAAAATAAGAA
TAGAGGATGTAGAGGCTGAG -> AGAGGATGTAGAGGCTGAGC
TCTTCTGGAAATGTCCAAAA -> CTTCTGGAAATGTCCAAAAT
CAGGCTTATCCTTAGACACG -> AGGCTTATCCTTAGACACGG
GCCCCATGCTGTAAGCGTGG -> CCCCATGCTGTAAGCGTGGT
AACTTGCCGCTCGTCTAGCG -> ACTTGCCGCTCGTCTAGCGT
TGTTTTCATATAGAGGACAG -> GTTTTCATATAGAGGACAGC
AGCATAGCCATACGGAGTTA -> GCATAGCCATACGGAGTTAC
GCCAGTCTACAAGAATCATT -> CCAGTCTACAAGAATCATTC
TCGATGGCGGCAAACTTGCC -> CGATGGCGGCAAACTTGCCG
GCTGGTAGGTAGGCGTCATA -> CTGGTAGGTAGGCGTCATAG
CCAGTCTACAAGAATCATTC -> CAGTCTACAAGAATCATTCG
TATAGTCCTACCATCTAGAA -> ATAGTCCTACCATCTAGAAT
GCTACATTCTCACGCCCCAT -> CTACATTCTCACGCCCCATG
CTCTCATCCTACCCCTTCTG -> TCTCATCCTACCCCTTCTGT
ATACACGACTTGGCGCCTGG -> TACACGACTTGGCGCCTGGG
AAGCTGGTAGGTAGGCGTCA -> AGCTGGTAGGTAGGCGTCAT
GAGGATGTAGAGGCTGAGCG -> AGGATGTAGAGGCTGAGCGA
CCCTCTCATCCTACCCCTTC -> CCTCTCATCCTACCCCTTCT
TCGCGTACTAGGTTCCAGGA -> CGCGTACTAGGTTCCAGGAC
ATAAGGCACGCCAGTCTACA -> TAAGGCACGCCAGTCTACAA
AACATAACGTACCAAGTGAA -> ACATAACGTACCAAGTGAAT
AACAGAAGACAGATAACTAG -> ACAGAAGACAGATAACTAGG
CGATTTTACCTGTAGCAATA -> GATTTTACCTGTAGCAATAC
GTCTTACGTCCGGATCACGT -> TCTTACGTCCGGATCACGTA
CAAATATTTAGCATCAATAG -> AAATATTTAGCATCAATAGA
CGGCACGCCTTGCGTGTGGG -> GGCACGCCTTGCGTGTGGGT
AATCATTCGTAAGCTGTAGT -> ATCATTCGTAAGCTGTAGTC
AGGCTTATCCTTAGACACGG -> GGCTTATCCTTAGACACGGC
CAATTGGATGGCGGCTATCG -> AATTGGATGGCGGCTATCGG
ATGTCCAAAATAAGAAGCAT -> TGTCCAAAATAAGAAGCATA
ACCCCTCGAGTAAACGCACG -> CCCCTCGAGTAAACGCACGT
TAAACGCACGTCGCGTACTA -> AAACGCACGTCGCGTACTAG
CCGGATCACGTACGCGTATG -> CGGATCACGTACGCGTATGA
AGACAGGCTTATCCTTAGAC -> GACAGGCTTATCCTTAGACA
CGGCAAACTTGCCGCTCGTC -> GGCAAACTTGCCGCTCGTCT
GACACGGCAAATTCCTCGGG -> ACACGGCAAATTCCTCGGGA
TACCATTGTAGTCGAGGGTC -> ACCATTGTAGTCGAGGGTCG
TGTGCCCATGGCTTTTCCTC -> GTGCCCATGGCTTTTCCTCA
CCATACGGAGTTACCATTGT -> CATACGGAGTTACCATTGTA
GCGACAATTGGATGGCGGCT -> CGACAATTGGATGGCGGCTA
CCTGAAAAGCTGGTAGGTAG -> CTGAAAAGCTGGTAGGTAGG
CTACATTCTCACGCCCCATG -> TACATTCTCACGCCCCATGC
GCGCCTGGGGGGCTTACGCA -> CGCCTGGGGGGCTTACGCAT
AACCCCTCGAGTAAACGCAC -> ACCCCTCGAGTAAACGCACG
CCCAATGCGATCCAACCACG -> CCAATGCGATCCAACCACGT
CATGCTGTAAGCGTGGTAAC -> ATGCTGTAAGCGTGGTAACC
CGCGTGGGGCATTAAGCCCG -> GCGTGGGGCATTAAGCCCGT
GCGGCAAACTTGCCGCTCGT -> CGGCAAACTTGCCGCTCGTC
GGTTCCAGGACTTATGCCGG -> GTTCCAGGACTTATGCCGGA
CCCCTCGAGTAAACGCACGT -> CCCTCGAGTAAACGCACGTC
ACCATTGTAGTCGAGGGTCG -> CCATTGTAGTCGAGGGTCGA
CTTCTGGAAATGTCCAAAAT -> TTCTGGAAATGTCCAAAATA
TCATATAGAGGACAGCCTTG -> CATATAGAGGACAGCCTTGT
ATTCTCACGCCCCATGCTGT -> TTCTCACGCCCCATGCTGTA
CAATGCAGTTCGATGGCGGC -> AATGCAGTTCGATGGCGGCA
CCATGGCTTTTCCTCAATGC -> CATGGCTTTTCCTCAATGCA
TTTTACCTGTAGCAATACAC -> TTTACCTGTAGCAATACACG
TGTAAGCGTGGTAACCTGAC -> GTAAGCGTGGTAACCTGACA
GCTGAGCGACAATTGGATGG -> CTGAGCGACAATTGGATGGC
ATCTTCTGGAAATGTCCAAA -> TCTTCTGGAAATGTCCAAAA
GCGTGGTAACCTGACAATCA -> CGTGGTAACCTGACAATCAC
TTTATAGTCCTACCATCTAG -> TTATAGTCCTACCATCTAGA
CACGGCCAGGCTTACGATCA -> ACGGCCAGGCTTACGATCAC
CAGCAGTTTCCGATTCTTAG -> AGCAGTTTCCGATTCTTAGA
ACCTGACAATCACGGCCAGG -> CCTGACAATCACGGCCAGGC
ATAACCCCTCGAGTAAACGC -> TAACCCCTCGAGTAAACGCA
TGGCCGCGCTCATCGCTAAC -> GGCCGCGCTCATCGCTAACA
GCCATATACCTATAGACAGG -> CCATATACCTATAGACAGGC
CTTACGTCCGGATCACGTAC -> TTACGTCCGGATCACGTACG
TATGTTTTCATATAGAGGAC -> ATGTTTTCATATAGAGGACA
TTAAGCCCGTGGTCTCATTT -> TAAGCCCGTGGTCTCATTTT
CGATCACAGCAGTTTCCGAT -> GATCACAGCAGTTTCCGATT
GCCCGTGGTCTCATTTTATG -> CCCGTGGTCTCATTTTATGT
ACGCCAGTCTACAAGAATCA -> CGCCAGTCTACAAGAATCAT
CTGACAATCACGGCCAGGCT -> TGACAATCACGGCCAGGCTT
GCCACGACCAATAGTGACAC -> CCACGACCAATAGTGACACA
AGTGACACAGATCTTCTGGA -> GTGACACAGATCTTCTGGAA
ACGGCCAGGCTTACGATCAC -> CGGCCAGGCTTACGATCACA
CTGTTGAGCCCAATGCGATC -> TGTTGAGCCCAATGCGATCC
GTCCGGATCACGTACGCGTA -> TCCGGATCACGTACGCGTAT
GCTCATCGCTAACATAACGT -> CTCATCGCTAACATAACGTA
CGCATTCTTACTGCACATGG -> GCATTCTTACTGCACATGGC
ACAGGCGTAATCTCCTTGCC -> CAGGCGTAATCTCCTTGCCT
CTAGAATGGTCCGTACGGTT -> TAGAATGGTCCGTACGGTTG
GCTTACGCATTCTTACTGCA -> CTTACGCATTCTTACTGCAC
GGTAGGTAGGCGTCATAGGC -> GTAGGTAGGCGTCATAGGCC
TGCCACGACCAATAGTGACA -> GCCACGACCAATAGTGACAC
AATGTTTCAAATATTTAGCA -> ATGTTTCAAATATTTAGCAT
CGTATGAATGCCCACCTAAG -> GTATGAATGCCCACCTAAGT
CCGATTCTTAGACAGGCGTA -> CGATTCTTAGACAGGCGTAA
ATGTAGAGGCTGAGCGACAA -> TGTAGAGGCTGAGCGACAAT
GCACGCCTTGCGTGTGGGTC -> CACGCCTTGCGTGTGGGTCA
GCACGTCGCGTACTAGGTTC -> CACGTCGCGTACTAGGTTCC
AACGCCTGAAAAGCTGGTAG -> ACGCCTGAAAAGCTGGTAGG
AAAGCTGGTAGGTAGGCGTC -> AAGCTGGTAGGTAGGCGTCA
TTTCATATAGAGGACAGCCT -> TTCATATAGAGGACAGCCTT
GCATTCTTACTGCACATGGC -> CATTCTTACTGCACATGGCC
TAAGCGTGGTAACCTGACAA -> AAGCGTGGTAACCTGACAAT
AAGGACTCAACGCCTGAAAA -> AGGACTCAACGCCTGAAAAG
ACTGGCACGCGTGGGGCATT -> CTGGCACGCGTGGGGCATTA
AGTCCTACCATCTAGAATGG -> GTCCTACCATCTAGAATGGT
ATAACGTACCAAGTGAATAA -> TAACGTACCAAGTGAATAAC
CCCACCTAAGTAGCAGCGCT -> CCACCTAAGTAGCAGCGCTG
CGGAGTTACCATTGTAGTCG -> GGAGTTACCATTGTAGTCGA
GTTGAGCCCAATGCGATCCA -> TTGAGCCCAATGCGATCCAA
TGGCGCCTGGGGGGCTTACG -> GGCGCCTGGGGGGCTTACGC
TTCCTCGGGACTATCACTGA -> TCCTCGGGACTATCACTGAC
CTCCTTGCCTACTGGCACGC -> TCCTTGCCTACTGGCACGCG
GGATGGCGGCTATCGGCTCG -> GATGGCGGCTATCGGCTCGC
AGACAGATAACTAGGTGTGC -> GACAGATAACTAGGTGTGCC
ACACGGCAAATTCCTCGGGA -> CACGGCAAATTCCTCGGGAC
CCTCTCATCCTACCCCTTCT -> CTCTCATCCTACCCCTTCTG
CGCTACATTCTCACGCCCCA -> GCTACATTCTCACGCCCCAT
TGGCTTTTCCTCAATGCAGT -> GGCTTTTCCTCAATGCAGTT
GACTTGGCGCCTGGGGGGCT -> ACTTGGCGCCTGGGGGGCTT
ACGATCACAGCAGTTTCCGA -> CGATCACAGCAGTTTCCGAT
GTTTCCCGCACGGCACGCCT -> TTTCCCGCACGGCACGCCTT
TGTAGCAATACACGACTTGG -> GTAGCAATACACGACTTGGC
GCCTGAAAAGCTGGTAGGTA -> CCTGAAAAGCTGGTAGGTAG
GTAAACGCACGTCGCGTACT -> TAAACGCACGTCGCGTACTA
TAACCCCTCGAGTAAACGCA -> AACCCCTCGAGTAAACGCAC
AACGTACCAAGTGAATAACC -> ACGTACCAAGTGAATAACCC
TGTTGAGCCCAATGCGATCC -> GTTGAGCCCAATGCGATCCA
AAATGTCCAAAATAAGAAGC -> AATGTCCAAAATAAGAAGCA
ATGCTGTAAGCGTGGTAACC -> TGCTGTAAGCGTGGTAACCT
CCATGCTGTAAGCGTGGTAA -> CATGCTGTAAGCGTGGTAAC
AGGCGTCATAGGCCGACCCA -> GGCGTCATAGGCCGACCCAG
AGCCCAATGCGATCCAACCA -> GCCCAATGCGATCCAACCAC
TTCTGGAAATGTCCAAAATA -> TCTGGAAATGTCCAAAATAA
CACGGCAAATTCCTCGGGAC -> ACGGCAAATTCCTCGGGACT
TCAACGCCTGAAAAGCTGGT -> CAACGCCTGAAAAGCTGGTA
TACGATCACAGCAGTTTCCG -> ACGATCACAGCAGTTTCCGA
ACGCACGTCGCGTACTAGGT -> CGCACGTCGCGTACTAGGTT
ACGGCAAATTCCTCGGGACT -> CGGCAAATTCCTCGGGACTA
ATTAATGTTTCAAATATTTA -> TTAATGTTTCAAATATTTAG
CGCGCTACATTCTCACGCCC -> GCGCTACATTCTCACGCCCC
ATCATTCGTAAGCTGTAGTC -> TCATTCGTAAGCTGTAGTCT
TTCTGTTGAGCCCAATGCGA -> TCTGTTGAGCCCAATGCGAT
GGTAACCTGACAATCACGGC -> GTAACCTGACAATCACGGCC
AGAATCATTCGTAAGCTGTA -> GAATCATTCGTAAGCTGTAG
CGTAAGCTGTAGTCTTACGT -> GTAAGCTGTAGTCTTACGTC
CTAAGTAGCAGCGCTGGGGT -> TAAGTAGCAGCGCTGGGGTA
TCTGGAAATGTCCAAAATAA -> CTGGAAATGTCCAAAATAAG
GTGACACAGATCTTCTGGAA -> TGACACAGATCTTCTGGAAA
TATGAATGCCCACCTAAGTA -> ATGAATGCCCACCTAAGTAG
CGCCTTGCGTGTGGGTCAAC -> GCCTTGCGTGTGGGTCAACG
AGCAGTTTCCGATTCTTAGA -> GCAGTTTCCGATTCTTAGAC
AATGGTCCGTACGGTTGCCA -> ATGGTCCGTACGGTTGCCAC
CAGTCTACAAGAATCATTCG -> AGTCTACAAGAATCATTCGT
CACGTACGCGTATGACGGCG -> ACGTACGCGTATGACGGCGG
CGCCATATACCTATAGACAG -> GCCATATACCTATAGACAGG
CAACGCCTGAAAAGCTGGTA -> AACGCCTGAAAAGCTGGTAG
ATAGTGACACAGATCTTCTG -> TAGTGACACAGATCTTCTGG
AACCACGTATGAATGCCCAC -> ACCACGTATGAATGCCCACC
GCCTTGCGTGTGGGTCAACG -> CCTTGCGTGTGGGTCAACGG
CAGATCTTCTGGAAATGTCC -> AGATCTTCTGGAAATGTCCA
GCCGCGCTCATCGCTAACAT -> CCGCGCTCATCGCTAACATA
GGCTATCGGCTCGCGCGCTA -> GCTATCGGCTCGCGCGCTAC
TTTCCTCAATGCAGTTCGAT -> TTCCTCAATGCAGTTCGATG
CAGCCTTGTACGCCATATAC -> AGCCTTGTACGCCATATACC
ACTGCACATGGCCGCGCTCA -> CTGCACATGGCCGCGCTCAT
AATATTTAGCATCAATAGAG -> ATATTTAGCATCAATAGAGG
GCGCGCTACATTCTCACGCC -> CGCGCTACATTCTCACGCCC
GGGTACATAAGGCACGCCAG -> GGTACATAAGGCACGCCAGT
TCTTGGTTTTTATCCCTCTC -> CTTGGTTTTTATCCCTCTCA
CCTCGAGTAAACGCACGTCG -> CTCGAGTAAACGCACGTCGC
AATTCCTCGGGACTATCACT -> ATTCCTCGGGACTATCACTG
GCATCAATAGAGGATGTAGA -> CATCAATAGAGGATGTAGAG
GACAGGCGTAATCTCCTTGC -> ACAGGCGTAATCTCCTTGCC
AACCTGACAATCACGGCCAG -> ACCTGACAATCACGGCCAGG
CAAACTTGCCGCTCGTCTAG -> AAACTTGCCGCTCGTCTAGC
TAGTCGAGGGTCGAGATGAC -> AGTCGAGGGTCGAGATGACA
GTGGTAACCTGACAATCACG -> TGGTAACCTGACAATCACGG
CCGCTCGTCTAGCGTTGACC -> CGCTCGTCTAGCGTTGACCC
GACCCAGGTCTTGGTTTTTA -> ACCCAGGTCTTGGTTTTTAT
CCTTGTACGCCATATACCTA -> CTTGTACGCCATATACCTAT
CGGATCACGTACGCGTATGA -> GGATCACGTACGCGTATGAC
GGTAGGCGTCATAGGCCGAC -> GTAGGCGTCATAGGCCGACC
CATTTTATGTTTTCATATAG -> ATTTTATGTTTTCATATAGA
TTGGATGGCGGCTATCGGCT -> TGGATGGCGGCTATCGGCTC
GTTCCAGGACTTATGCCGGA -> TTCCAGGACTTATGCCGGAT
ACGTTCTGCCACGACCAATA -> CGTTCTGCCACGACCAATAG
GGCACGCCTTGCGTGTGGGT -> GCACGCCTTGCGTGTGGGTC
TAGCAATACACGACTTGGCG -> AGCAATACACGACTTGGCGC
AGGCTTACGATCACAGCAGT -> GGCTTACGATCACAGCAGTT
GTCTCATTTTATGTTTTCAT -> TCTCATTTTATGTTTTCATA
TTAGACACGGCAAATTCCTC -> TAGACACGGCAAATTCCTCG
AGGTTCCAGGACTTATGCCG -> GGTTCCAGGACTTATGCCGG
TCTCCTTGCCTACTGGCACG -> CTCCTTGCCTACTGGCACGC
GAGGACAGCCTTGTACGCCA -> AGGACAGCCTTGTACGCCAT
TAGGTGTGCCCATGGCTTTT -> AGGTGTGCCCATGGCTTTTC
TCACGGCCAGGCTTACGATC -> CACGGCCAGGCTTACGATCA
CGTACTAGGTTCCAGGACTT -> GTACTAGGTTCCAGGACTTA
TTTTCATATAGAGGACAGCC -> TTTCATATAGAGGACAGCCT
CATGGCTTTTCCTCAATGCA -> ATGGCTTTTCCTCAATGCAG
TATCCTTAGACACGGCAAAT -> ATCCTTAGACACGGCAAATT
TATGACGGCGGGTCGATTTT -> ATGACGGCGGGTCGATTTTA
TGGGGTACATAAGGCACGCC -> GGGGTACATAAGGCACGCCA
CGTCATAGGCCGACCCAGGT -> GTCATAGGCCGACCCAGGTC
ACGACCAATAGTGACACAGA -> CGACCAATAGTGACACAGAT
ATATTTAGCATCAATAGAGG -> TATTTAGCATCAATAGAGGA
TTCGTAAGCTGTAGTCTTAC -> TCGTAAGCTGTAGTCTTACG
TCTACAAGAATCATTCGTAA -> CTACAAGAATCATTCGTAAG
CGCGCTCATCGCTAACATAA -> GCGCTCATCGCTAACATAAC
ACGGTGAAATTAATGTTTCA -> CGGTGAAATTAATGTTTCAA
TAACATAACGTACCAAGTGA -> AACATAACGTACCAAGTGAA
GGCTCGCGCGCTACATTCTC -> GCTCGCGCGCTACATTCTCA
TCTTACGTCCGGATCACGTA -> CTTACGTCCGGATCACGTAC
ACAGCCTTGTACGCCATATA -> CAGCCTTGTACGCCATATAC
TCCGATTCTTAGACAGGCGT -> CCGATTCTTAGACAGGCGTA
GGCAAATTCCTCGGGACTAT -> GCAAATTCCTCGGGACTATC
ATTAAGCCCGTGGTCTCATT -> TTAAGCCCGTGGTCTCATTT
TGGGGCATTAAGCCCGTGGT -> GGGGCATTAAGCCCGTGGTC
CTTACGCATTCTTACTGCAC -> TTACGCATTCTTACTGCACA
CTATCGGCTCGCGCGCTACA -> TATCGGCTCGCGCGCTACAT
CGACTTGGCGCCTGGGGGGC -> GACTTGGCGCCTGGGGGGCT
CCCCATGCTGTAAGCGTGGT -> CCCATGCTGTAAGCGTGGTA
CACGACCAATAGTGACACAG -> ACGACCAATAGTGACACAGA
CTAGGTGTGCCCATGGCTTT -> TAGGTGTGCCCATGGCTTTT
TAGCATCAATAGAGGATGTA -> AGCATCAATAGAGGATGTAG
CTGGTAGGTAGGCGTCATAG -> TGGTAGGTAGGCGTCATAGG
CGCCCCATGCTGTAAGCGTG -> GCCCCATGCTGTAAGCGTGG
ACGTACCAAGTGAATAACCC -> CGTACCAAGTGAATAACCCC
GCGTTGACCCGTAAGGACTC -> CGTTGACCCGTAAGGACTCA
CGCTCGTCTAGCGTTGACCC -> GCTCGTCTAGCGTTGACCCG
ACGGCGGGTCGATTTTACCT -> CGGCGGGTCGATTTTACCTG
ATTTAGCATCAATAGAGGAT -> TTTAGCATCAATAGAGGATG
CCAGGACTTATGCCGGATAC -> CAGGACTTATGCCGGATACG
CTATAGACAGGCTTATCCTT -> TATAGACAGGCTTATCCTTA
GTAGGTAGGCGTCATAGGCC -> TAGGTAGGCGTCATAGGCCG
ATTCTTAGACAGGCGTAATC -> TTCTTAGACAGGCGTAATCT
CTTACGATCACAGCAGTTTC -> TTACGATCACAGCAGTTTCC
ACGCGTGGGGCATTAAGCCC -> CGCGTGGGGCATTAAGCCCG
GCACGCGTGGGGCATTAAGC -> CACGCGTGGGGCATTAAGCC
CTGACGTTCTGCCACGACCA -> TGACGTTCTGCCACGACCAA
ATTTTACCTGTAGCAATACA -> TTTTACCTGTAGCAATACAC
TGGGTCAACGGTGAAATTAA -> GGGTCAACGGTGAAATTAAT
ATAAGAAGCATAGCCATACG -> TAAGAAGCATAGCCATACGG
GCGTGGGGCATTAAGCCCGT -> CGTGGGGCATTAAGCCCGTG
GCTCGTCTAGCGTTGACCCG -> CTCGTCTAGCGTTGACCCGT
GGATCACGTACGCGTATGAC -> GATCACGTACGCGTATGACG
AATGCCCACCTAAGTAGCAG -> ATGCCCACCTAAGTAGCAGC
GACACAGATCTTCTGGAAAT -> ACACAGATCTTCTGGAAATG
AAATTAATGTTTCAAATATT -> AATTAATGTTTCAAATATTT
TCGAGTAAACGCACGTCGCG -> CGAGTAAACGCACGTCGCGT
TATAGAGGACAGCCTTGTAC -> ATAGAGGACAGCCTTGTACG
ATCAATAGAGGATGTAGAGG -> TCAATAGAGGATGTAGAGGC
AACGCACGTCGCGTACTAGG -> ACGCACGTCGCGTACTAGGT
TGGTCTCATTTTATGTTTTC -> GGTCTCATTTTATGTTTTCA
AGATGACATTTTATAGTCCT -> GATGACATTTTATAGTCCTA
CCAAAATAAGAAGCATAGCC -> CAAAATAAGAAGCATAGCCA
CTCAACGCCTGAAAAGCTGG -> TCAACGCCTGAAAAGCTGGT
ACGCCCCATGCTGTAAGCGT -> CGCCCCATGCTGTAAGCGTG
TCATCGCTAACATAACGTAC -> CATCGCTAACATAACGTACC
CAGAAGACAGATAACTAGGT -> AGAAGACAGATAACTAGGTG
AGGTGTGCCCATGGCTTTTC -> GGTGTGCCCATGGCTTTTCC
CGTAAGGACTCAACGCCTGA -> GTAAGGACTCAACGCCTGAA
CACGCCAGTCTACAAGAATC -> ACGCCAGTCTACAAGAATCA
ACCATCTAGAATGGTCCGTA -> CCATCTAGAATGGTCCGTAC
ATCGCTAACATAACGTACCA -> TCGCTAACATAACGTACCAA
TGACGTTCTGCCACGACCAA -> GACGTTCTGCCACGACCAAT
ACGACTTGGCGCCTGGGGGG -> CGACTTGGCGCCTGGGGGGC
AGGCTGAGCGACAATTGGAT -> GGCTGAGCGACAATTGGATG
TCCTCAATGCAGTTCGATGG -> CCTCAATGCAGTTCGATGGC
TGAATAACCCCTCGAGTAAA -> GAATAACCCCTCGAGTAAAC
TGACACAGATCTTCTGGAAA -> GACACAGATCTTCTGGAAAT
GGTCAACGGTGAAATTAATG -> GTCAACGGTGAAATTAATGT
CCGTGGTCTCATTTTATGTT -> CGTGGTCTCATTTTATGTTT
CAGCGCTGGGGTACATAAGG -> AGCGCTGGGGTACATAAGGC
TAAGCCCGTGGTCTCATTTT -> AAGCCCGTGGTCTCATTTTA
ACATGGCCGCGCTCATCGCT -> CATGGCCGCGCTCATCGCTA
GGGCTTACGCATTCTTACTG -> GGCTTACGCATTCTTACTGC
TGTAGAGGCTGAGCGACAAT -> GTAGAGGCTGAGCGACAATT
CATCTAGAATGGTCCGTACG -> ATCTAGAATGGTCCGTACGG
GCGGGTCGATTTTACCTGTA -> CGGGTCGATTTTACCTGTAG
AGGACAGCCTTGTACGCCAT -> GGACAGCCTTGTACGCCATA
CCAAGTGAATAACCCCTCGA -> CAAGTGAATAACCCCTCGAG
TTCCCGCACGGCACGCCTTG -> TCCCGCACGGCACGCCTTGC
CATATAGAGGACAGCCTTGT -> ATATAGAGGACAGCCTTGTA
CATTAAGCCCGTGGTCTCAT -> ATTAAGCCCGTGGTCTCATT
GGGCATTAAGCCCGTGGTCT -> GGCATTAAGCCCGTGGTCTC
TCAATGCAGTTCGATGGCGG -> CAATGCAGTTCGATGGCGGC
TTAGCATCAATAGAGGATGT -> TAGCATCAATAGAGGATGTA
GTCCAAAATAAGAAGCATAG -> TCCAAAATAAGAAGCATAGC
CTTGGCGCCTGGGGGGCTTA -> TTGGCGCCTGGGGGGCTTAC
GCCCAATGCGATCCAACCAC -> CCCAATGCGATCCAACCACG
TACCAAGTGAATAACCCCTC -> ACCAAGTGAATAACCCCTCG
ATAGTCCTACCATCTAGAAT -> TAGTCCTACCATCTAGAATG
CGTGTGGGTCAACGGTGAAA -> GTGTGGGTCAACGGTGAAAT
TAGCGTTGACCCGTAAGGAC -> AGCGTTGACCCGTAAGGACT
CTCATCGCTAACATAACGTA -> TCATCGCTAACATAACGTAC
TGGTAGGTAGGCGTCATAGG -> GGTAGGTAGGCGTCATAGGC
TGAAATTAATGTTTCAAATA -> GAAATTAATGTTTCAAATAT
TTTAGCATCAATAGAGGATG -> TTAGCATCAATAGAGGATGT
ACCCGTAAGGACTCAACGCC -> CCCGTAAGGACTCAACGCCT
TCTTAGACAGGCGTAATCTC -> CTTAGACAGGCGTAATCTCC
TCCCTCTCATCCTACCCCTT -> CCCTCTCATCCTACCCCTTC
CAGGCTTACGATCACAGCAG -> AGGCTTACGATCACAGCAGT
GGCGTGGCAGATGAACAGAA -> GCGTGGCAGATGAACAGAAG
CATTCTTACTGCACATGGCC -> ATTCTTACTGCACATGGCCG
AAATAAGAAGCATAGCCATA -> AATAAGAAGCATAGCCATAC
ACATTTTATAGTCCTACCAT -> CATTTTATAGTCCTACCATC
TCCTTAGACACGGCAAATTC -> CCTTAGACACGGCAAATTCC
TTCCTCAATGCAGTTCGATG -> TCCTCAATGCAGTTCGATGG
GTTTCAAATATTTAGCATCA -> TTTCAAATATTTAGCATCAA
CCTAAGTAGCAGCGCTGGGG -> CTAAGTAGCAGCGCTGGGGT
CTGTAGTCTTACGTCCGGAT -> TGTAGTCTTACGTCCGGATC
TTTTATAGTCCTACCATCTA -> TTTATAGTCCTACCATCTAG
AGTAGCAGCGCTGGGGTACA -> GTAGCAGCGCTGGGGTACAT
CATTCTCACGCCCCATGCTG -> ATTCTCACGCCCCATGCTGT
CCAATAGTGACACAGATCTT -> CAATAGTGACACAGATCTTC
CTACCCCTTCTGTTGAGCCC -> TACCCCTTCTGTTGAGCCCA
TGCGATCCAACCACGTATGA -> GCGATCCAACCACGTATGAA
GCCCCGTTTCCCGCACGGCA -> CCCCGTTTCCCGCACGGCAC
AATGTCCAAAATAAGAAGCA -> ATGTCCAAAATAAGAAGCAT
ACAAGAATCATTCGTAAGCT -> CAAGAATCATTCGTAAGCTG
CGGGTCGATTTTACCTGTAG -> GGGTCGATTTTACCTGTAGC
CCCGCACGGCACGCCTTGCG -> CCGCACGGCACGCCTTGCGT
GCCTGGGGGGCTTACGCATT -> CCTGGGGGGCTTACGCATTC
TCGGGACTATCACTGACGTT -> CGGGACTATCACTGACGTTC
CTGAAAAGCTGGTAGGTAGG -> TGAAAAGCTGGTAGGTAGGC
TAGACAGGCGTAATCTCCTT -> AGACAGGCGTAATCTCCTTG
GCAGCGCTGGGGTACATAAG -> CAGCGCTGGGGTACATAAGG
CCCCTTCTGTTGAGCCCAAT -> CCCTTCTGTTGAGCCCAATG
CGTCAGTGGCCCCGTTTCCC -> GTCAGTGGCCCCGTTTCCCG
TAGGTAGGCGTCATAGGCCG -> AGGTAGGCGTCATAGGCCGA
GAACAGAAGACAGATAACTA -> AACAGAAGACAGATAACTAG
AATGCAGTTCGATGGCGGCA -> ATGCAGTTCGATGGCGGCAA
TAGTCCTACCATCTAGAATG -> AGTCCTACCATCTAGAATGG
ACAGGCTTATCCTTAGACAC -> CAGGCTTATCCTTAGACACG
GTCCTACCATCTAGAATGGT -> TCCTACCATCTAGAATGGTC
TCTCATTTTATGTTTTCATA -> CTCATTTTATGTTTTCATAT
AGATAACTAGGTGTGCCCAT -> GATAACTAGGTGTGCCCATG
CTAACATAACGTACCAAGTG -> TAACATAACGTACCAAGTGA
AATAGAGGATGTAGAGGCTG -> ATAGAGGATGTAGAGGCTGA
CACGTGGCGTGGCAGATGAA -> ACGTGGCGTGGCAGATGAAC
AATACACGACTTGGCGCCTG -> ATACACGACTTGGCGCCTGG
GCGTCATAGGCCGACCCAGG -> CGTCATAGGCCGACCCAGGT
CCAGGTCTTGGTTTTTATCC -> CAGGTCTTGGTTTTTATCCC
AGGTAGGCGTCATAGGCCGA -> GGTAGGCGTCATAGGCCGAC
CTTTTCCTCAATGCAGTTCG -> TTTTCCTCAATGCAGTTCGA
GGTCCGTACGGTTGCCACGT -> GTCCGTACGGTTGCCACGTG
ACAATTGGATGGCGGCTATC -> CAATTGGATGGCGGCTATCG
TTACCTGTAGCAATACACGA -> TACCTGTAGCAATACACGAC
GATGACATTTTATAGTCCTA -> ATGACATTTTATAGTCCTAC
AGATCTTCTGGAAATGTCCA -> GATCTTCTGGAAATGTCCAA
CTCATTTTATGTTTTCATAT -> TCATTTTATGTTTTCATATA
TCATCCTACCCCTTCTGTTG -> CATCCTACCCCTTCTGTTGA
ATGGCGGCAAACTTGCCGCT -> TGGCGGCAAACTTGCCGCTC
CGTTGACCCGTAAGGACTCA -> GTTGACCCGTAAGGACTCAA
GATGGCGGCTATCGGCTCGC -> ATGGCGGCTATCGGCTCGCG
AGAAGCATAGCCATACGGAG -> GAAGCATAGCCATACGGAGT
CCTTCTGTTGAGCCCAATGC -> CTTCTGTTGAGCCCAATGCG
GGCTGAGCGACAATTGGATG -> GCTGAGCGACAATTGGATGG
CCCTTCTGTTGAGCCCAATG -> CCTTCTGTTGAGCCCAATGC
TAGCAGCGCTGGGGTACATA -> AGCAGCGCTGGGGTACATAA
TATAGACAGGCTTATCCTTA -> ATAGACAGGCTTATCCTTAG
TCCAGGACTTATGCCGGATA -> CCAGGACTTATGCCGGATAC
CACCTAAGTAGCAGCGCTGG -> ACCTAAGTAGCAGCGCTGGG
TGACGGCGGGTCGATTTTAC -> GACGGCGGGTCGATTTTACC
GAATAACCCCTCGAGTAAAC -> AATAACCCCTCGAGTAAACG
GCTTACGATCACAGCAGTTT -> CTTACGATCACAGCAGTTTC
CGACCCAGGTCTTGGTTTTT -> GACCCAGGTCTTGGTTTTTA
CGCGCGCTACATTCTCACGC -> GCGCGCTACATTCTCACGCC
AGTTACCATTGTAGTCGAGG -> GTTACCATTGTAGTCGAGGG
ATAGCCATACGGAGTTACCA -> TAGCCATACGGAGTTACCAT
ATCGGCTCGCGCGCTACATT -> TCGGCTCGCGCGCTACATTC
GCAGTTCGATGGCGGCAAAC -> CAGTTCGATGGCGGCAAACT
GTCATAGGCCGACCCAGGTC -> TCATAGGCCGACCCAGGTCT
GGGTCGAGATGACATTTTAT -> GGTCGAGATGACATTTTATA
CTTGCCTACTGGCACGCGTG -> TTGCCTACTGGCACGCGTGG
TGAGCGACAATTGGATGGCG -> GAGCGACAATTGGATGGCGG
CTTACTGCACATGGCCGCGC -> TTACTGCACATGGCCGCGCT
CCACGTGGCGTGGCAGATGA -> CACGTGGCGTGGCAGATGAA
TACGCATTCTTACTGCACAT -> ACGCATTCTTACTGCACATG
GACAGGCTTATCCTTAGACA -> ACAGGCTTATCCTTAGACAC
GGCAAACTTGCCGCTCGTCT -> GCAAACTTGCCGCTCGTCTA
CATACGGAGTTACCATTGTA -> ATACGGAGTTACCATTGTAG
AGCCCGTGGTCTCATTTTAT -> GCCCGTGGTCTCATTTTATG
TCAAATATTTAGCATCAATA -> CAAATATTTAGCATCAATAG
CCATTGTAGTCGAGGGTCGA -> CATTGTAGTCGAGGGTCGAG
ATATACCTATAGACAGGCTT -> TATACCTATAGACAGGCTTA
GTAGAGGCTGAGCGACAATT -> TAGAGGCTGAGCGACAATTG
TAACCTGACAATCACGGCCA -> AACCTGACAATCACGGCCAG
AGCCATACGGAGTTACCATT -> GCCATACGGAGTTACCATTG
CCTGACAATCACGGCCAGGC -> CTGACAATCACGGCCAGGCT
CGGCAAATTCCTCGGGACTA -> GGCAAATTCCTCGGGACTAT
CCAACCACGTATGAATGCCC -> CAACCACGTATGAATGCCCA
ATCCAACCACGTATGAATGC -> TCCAACCACGTATGAATGCC
TGGCCCCGTTTCCCGCACGG -> GGCCCCGTTTCCCGCACGGC
GCCTACTGGCACGCGTGGGG -> CCTACTGGCACGCGTGGGGC
CTTCTGTTGAGCCCAATGCG -> TTCTGTTGAGCCCAATGCGA
GGCTTTTCCTCAATGCAGTT -> GCTTTTCCTCAATGCAGTTC
TGGTCCGTACGGTTGCCACG -> GGTCCGTACGGTTGCCACGT
GGACTATCACTGACGTTCTG -> GACTATCACTGACGTTCTGC
GATCTTCTGGAAATGTCCAA -> ATCTTCTGGAAATGTCCAAA
TCCTCGGGACTATCACTGAC -> CCTCGGGACTATCACTGACG
ATCACGTACGCGTATGACGG -> TCACGTACGCGTATGACGGC
TCATTTTATGTTTTCATATA -> CATTTTATGTTTTCATATAG
GAATCATTCGTAAGCTGTAG -> AATCATTCGTAAGCTGTAGT
CCACGTATGAATGCCCACCT -> CACGTATGAATGCCCACCTA
GGCGTCATAGGCCGACCCAG -> GCGTCATAGGCCGACCCAGG
TACTGGCACGCGTGGGGCAT -> ACTGGCACGCGTGGGGCATT
AATCACGGCCAGGCTTACGA -> ATCACGGCCAGGCTTACGAT
CATTCGTAAGCTGTAGTCTT -> ATTCGTAAGCTGTAGTCTTA
GTGCCCATGGCTTTTCCTCA -> TGCCCATGGCTTTTCCTCAA
TAGACACGGCAAATTCCTCG -> AGACACGGCAAATTCCTCGG
TAGTGACACAGATCTTCTGG -> AGTGACACAGATCTTCTGGA
GCACGCCAGTCTACAAGAAT -> CACGCCAGTCTACAAGAATC
TAGGCCGACCCAGGTCTTGG -> AGGCCGACCCAGGTCTTGGT
GTTCTGCCACGACCAATAGT -> TTCTGCCACGACCAATAGTG
ATGGTCCGTACGGTTGCCAC -> TGGTCCGTACGGTTGCCACG
CCTACCCCTTCTGTTGAGCC -> CTACCCCTTCTGTTGAGCCC
AGATGAACAGAAGACAGATA -> GATGAACAGAAGACAGATAA
GAATGCCCACCTAAGTAGCA -> AATGCCCACCTAAGTAGCAG
TCGAGATGACATTTTATAGT -> CGAGATGACATTTTATAGTC
TAAGGACTCAACGCCTGAAA -> AAGGACTCAACGCCTGAAAA
TGACATTTTATAGTCCTACC -> GACATTTTATAGTCCTACCA
TTATGTTTTCATATAGAGGA -> TATGTTTTCATATAGAGGAC
TCATAGGCCGACCCAGGTCT -> CATAGGCCGACCCAGGTCTT
GGTCGATTTTACCTGTAGCA -> GTCGATTTTACCTGTAGCAA
TATCCCTCTCATCCTACCCC -> ATCCCTCTCATCCTACCCCT
TACGCGTATGACGGCGGGTC -> ACGCGTATGACGGCGGGTCG
AGTCGAGGGTCGAGATGACA -> GTCGAGGGTCGAGATGACAT
CATAACGTACCAAGTGAATA -> ATAACGTACCAAGTGAATAA
CATAGGCCGACCCAGGTCTT -> ATAGGCCGACCCAGGTCTTG
GTTTTTATCCCTCTCATCCT -> TTTTTATCCCTCTCATCCTA
AAGTAGCAGCGCTGGGGTAC -> AGTAGCAGCGCTGGGGTACA
CCGCGCTCATCGCTAACATA -> CGCGCTCATCGCTAACATAA
CTTGCCGCTCGTCTAGCGTT -> TTGCCGCTCGTCTAGCGTTG
CCTATAGACAGGCTTATCCT -> CTATAGACAGGCTTATCCTT
GAGGCTGAGCGACAATTGGA -> AGGCTGAGCGACAATTGGAT
TACACGACTTGGCGCCTGGG -> ACACGACTTGGCGCCTGGGG
GGCATTAAGCCCGTGGTCTC -> GCATTAAGCCCGTGGTCTCA
ATGAATGCCCACCTAAGTAG -> TGAATGCCCACCTAAGTAGC
CGTAATCTCCTTGCCTACTG -> GTAATCTCCTTGCCTACTGG
ATTGGATGGCGGCTATCGGC -> TTGGATGGCGGCTATCGGCT
CAGTTTCCGATTCTTAGACA -> AGTTTCCGATTCTTAGACAG
AGTTCGATGGCGGCAAACTT -> GTTCGATGGCGGCAAACTTG
GTGGGGCATTAAGCCCGTGG -> TGGGGCATTAAGCCCGTGGT
TGAATGCCCACCTAAGTAGC -> GAATGCCCACCTAAGTAGCA
CCTTGCCTACTGGCACGCGT -> CTTGCCTACTGGCACGCGTG
CGAGGGTCGAGATGACATTT -> GAGGGTCGAGATGACATTTT
TAGGCGTCATAGGCCGACCC -> AGGCGTCATAGGCCGACCCA
TGTACGCCATATACCTATAG -> GTACGCCATATACCTATAGA
TTACGTCCGGATCACGTACG -> TACGTCCGGATCACGTACGC
ACAGATAACTAGGTGTGCCC -> CAGATAACTAGGTGTGCCCA
TTCTCACGCCCCATGCTGTA -> TCTCACGCCCCATGCTGTAA
AGCTGTAGTCTTACGTCCGG -> GCTGTAGTCTTACGTCCGGA
CAATGCGATCCAACCACGTA -> AATGCGATCCAACCACGTAT
GTATGAATGCCCACCTAAGT -> TATGAATGCCCACCTAAGTA
TTGTAGTCGAGGGTCGAGAT -> TGTAGTCGAGGGTCGAGATG
AAGAATCATTCGTAAGCTGT -> AGAATCATTCGTAAGCTGTA
GAGGGTCGAGATGACATTTT -> AGGGTCGAGATGACATTTTA
AAACTTGCCGCTCGTCTAGC -> AACTTGCCGCTCGTCTAGCG
GCGGCTATCGGCTCGCGCGC -> CGGCTATCGGCTCGCGCGCT
GCCTTGTACGCCATATACCT -> CCTTGTACGCCATATACCTA
TACATTCTCACGCCCCATGC -> ACATTCTCACGCCCCATGCT
AAGCATAGCCATACGGAGTT -> AGCATAGCCATACGGAGTTA
GTCGATTTTACCTGTAGCAA -> TCGATTTTACCTGTAGCAAT
GTCGAGATGACATTTTATAG -> TCGAGATGACATTTTATAGT
TTACCATTGTAGTCGAGGGT -> TACCATTGTAGTCGAGGGTC
GATGAACAGAAGACAGATAA -> ATGAACAGAAGACAGATAAC
ATCACAGCAGTTTCCGATTC -> TCACAGCAGTTTCCGATTCT
CCTACCATCTAGAATGGTCC -> CTACCATCTAGAATGGTCCG
GGACAGCCTTGTACGCCATA -> GACAGCCTTGTACGCCATAT
ATGGCGGCTATCGGCTCGCG -> TGGCGGCTATCGGCTCGCGC
CTGGGGGGCTTACGCATTCT -> TGGGGGGCTTACGCATTCTT
TGAACAGAAGACAGATAACT -> GAACAGAAGACAGATAACTA
CCACCTAAGTAGCAGCGCTG -> CACCTAAGTAGCAGCGCTGG
CTTGGTTTTTATCCCTCTCA -> TTGGTTTTTATCCCTCTCAT
CATTTTATAGTCCTACCATC -> ATTTTATAGTCCTACCATCT
ACGCGTATGACGGCGGGTCG -> CGCGTATGACGGCGGGTCGA
TTACGCATTCTTACTGCACA -> TACGCATTCTTACTGCACAT
CCATCTAGAATGGTCCGTAC -> CATCTAGAATGGTCCGTACG
TGCGTGTGGGTCAACGGTGA -> GCGTGTGGGTCAACGGTGAA
CGCGTATGACGGCGGGTCGA -> GCGTATGACGGCGGGTCGAT
GCATTAAGCCCGTGGTCTCA -> CATTAAGCCCGTGGTCTCAT
TGGCGGCAAACTTGCCGCTC -> GGCGGCAAACTTGCCGCTCG
GAGATGACATTTTATAGTCC -> AGATGACATTTTATAGTCCT
GCCCACCTAAGTAGCAGCGC -> CCCACCTAAGTAGCAGCGCT
TGACAATCACGGCCAGGCTT -> GACAATCACGGCCAGGCTTA
TTTCCGATTCTTAGACAGGC -> TTCCGATTCTTAGACAGGCG
ATCTAGAATGGTCCGTACGG -> TCTAGAATGGTCCGTACGGT
GTCTAGCGTTGACCCGTAAG -> TCTAGCGTTGACCCGTAAGG
ACCCCTTCTGTTGAGCCCAA -> CCCCTTCTGTTGAGCCCAAT
AGCATCAATAGAGGATGTAG -> GCATCAATAGAGGATGTAGA
TAATGTTTCAAATATTTAGC -> AATGTTTCAAATATTTAGCA
CCGCACGGCACGCCTTGCGT -> CGCACGGCACGCCTTGCGTG
GTACGCGTATGACGGCGGGT -> TACGCGTATGACGGCGGGTC
CCTGGGGGGCTTACGCATTC -> CTGGGGGGCTTACGCATTCT
GCAAACTTGCCGCTCGTCTA -> CAAACTTGCCGCTCGTCTAG
CTACCATCTAGAATGGTCCG -> TACCATCTAGAATGGTCCGT
TACGGTTGCCACGTGGCGTG -> ACGGTTGCCACGTGGCGTGG
GTAGCAATACACGACTTGGC -> TAGCAATACACGACTTGGCG
CCTTGCGTGTGGGTCAACGG -> CTTGCGTGTGGGTCAACGGT
TCTTACTGCACATGGCCGCG -> CTTACTGCACATGGCCGCGC
CGTTCTGCCACGACCAATAG -> GTTCTGCCACGACCAATAGT
GCCGCTCGTCTAGCGTTGAC -> CCGCTCGTCTAGCGTTGACC
TGGCGGCTATCGGCTCGCGC -> GGCGGCTATCGGCTCGCGCG
TTGCCGCTCGTCTAGCGTTG -> TGCCGCTCGTCTAGCGTTGA
GCCGACCCAGGTCTTGGTTT -> CCGACCCAGGTCTTGGTTTT
CGCTGGGGTACATAAGGCAC -> GCTGGGGTACATAAGGCACG
GTACGCCATATACCTATAGA -> TACGCCATATACCTATAGAC
CATCGCTAACATAACGTACC -> ATCGCTAACATAACGTACCA
CGGGACTATCACTGACGTTC -> GGGACTATCACTGACGTTCT
GGCTTACGCATTCTTACTGC -> GCTTACGCATTCTTACTGCA
GTAGCAGCGCTGGGGTACAT -> TAGCAGCGCTGGGGTACATA
TCCAAAATAAGAAGCATAGC -> CCAAAATAAGAAGCATAGCC
GAAAAGCTGGTAGGTAGGCG -> AAAAGCTGGTAGGTAGGCGT
CTATCACTGACGTTCTGCCA -> TATCACTGACGTTCTGCCAC
TCACGTACGCGTATGACGGC -> CACGTACGCGTATGACGGCG
AGAGGCTGAGCGACAATTGG -> GAGGCTGAGCGACAATTGGA
TGGTAACCTGACAATCACGG -> GGTAACCTGACAATCACGGC
TGTAGTCTTACGTCCGGATC -> GTAGTCTTACGTCCGGATCA
GTCAACGGTGAAATTAATGT -> TCAACGGTGAAATTAATGTT
TGCACATGGCCGCGCTCATC -> GCACATGGCCGCGCTCATCG
GGGGGCTTACGCATTCTTAC -> GGGGCTTACGCATTCTTACT
GACAATCACGGCCAGGCTTA -> ACAATCACGGCCAGGCTTAC
CGCCTGGGGGGCTTACGCAT -> GCCTGGGGGGCTTACGCATT
GGACTCAACGCCTGAAAAGC -> GACTCAACGCCTGAAAAGCT
AGAGGATGTAGAGGCTGAGC -> GAGGATGTAGAGGCTGAGCG
ATTTTATAGTCCTACCATCT -> TTTTATAGTCCTACCATCTA
TCCCGCACGGCACGCCTTGC -> CCCGCACGGCACGCCTTGCG
GACAATTGGATGGCGGCTAT -> ACAATTGGATGGCGGCTATC
AGGGTCGAGATGACATTTTA -> GGGTCGAGATGACATTTTAT
ACCAAGTGAATAACCCCTCG -> CCAAGTGAATAACCCCTCGA
TCATTCGTAAGCTGTAGTCT -> CATTCGTAAGCTGTAGTCTT
ACTAGGTGTGCCCATGGCTT -> CTAGGTGTGCCCATGGCTTT
GTAAGGACTCAACGCCTGAA -> TAAGGACTCAACGCCTGAAA
GAAGACAGATAACTAGGTGT -> AAGACAGATAACTAGGTGTG
ACGCCATATACCTATAGACA -> CGCCATATACCTATAGACAG
GCAGATGAACAGAAGACAGA -> CAGATGAACAGAAGACAGAT
GGGGCTTACGCATTCTTACT -> GGGCTTACGCATTCTTACTG
CCCATGGCTTTTCCTCAATG -> CCATGGCTTTTCCTCAATGC
GTAGTCTTACGTCCGGATCA -> TAGTCTTACGTCCGGATCAC
GATCACAGCAGTTTCCGATT -> ATCACAGCAGTTTCCGATTC
CGAGTAAACGCACGTCGCGT -> GAGTAAACGCACGTCGCGTA
GGTCTCATTTTATGTTTTCA -> GTCTCATTTTATGTTTTCAT
CCAATGCGATCCAACCACGT -> CAATGCGATCCAACCACGTA
TGGCGTGGCAGATGAACAGA -> GGCGTGGCAGATGAACAGAA
CTACAAGAATCATTCGTAAG -> TACAAGAATCATTCGTAAGC
CGGTTGCCACGTGGCGTGGC -> GGTTGCCACGTGGCGTGGCA
GTAATCTCCTTGCCTACTGG -> TAATCTCCTTGCCTACTGGC
GAAATGTCCAAAATAAGAAG -> AAATGTCCAAAATAAGAAGC
ATACCTATAGACAGGCTTAT -> TACCTATAGACAGGCTTATC
GGCCGCGCTCATCGCTAACA -> GCCGCGCTCATCGCTAACAT
ATACGGAGTTACCATTGTAG -> TACGGAGTTACCATTGTAGT
TACGTCCGGATCACGTACGC -> ACGTCCGGATCACGTACGCG
TGACCCGTAAGGACTCAACG -> GACCCGTAAGGACTCAACGC
TACCTATAGACAGGCTTATC -> ACCTATAGACAGGCTTATCC
GATTCTTAGACAGGCGTAAT -> ATTCTTAGACAGGCGTAATC
CACGCCCCATGCTGTAAGCG -> ACGCCCCATGCTGTAAGCGT
ATTGTAGTCGAGGGTCGAGA -> TTGTAGTCGAGGGTCGAGAT
GCTAACATAACGTACCAAGT -> CTAACATAACGTACCAAGTG
AAATATTTAGCATCAATAGA -> AATATTTAGCATCAATAGAG
GGCACGCGTGGGGCATTAAG -> GCACGCGTGGGGCATTAAGC
CGATGGCGGCAAACTTGCCG -> GATGGCGGCAAACTTGCCGC
TTATAGTCCTACCATCTAGA -> TATAGTCCTACCATCTAGAA
TGTGGGTCAACGGTGAAATT -> GTGGGTCAACGGTGAAATTA
CACGCGTGGGGCATTAAGCC -> ACGCGTGGGGCATTAAGCCC
CTTAGACAGGCGTAATCTCC -> TTAGACAGGCGTAATCTCCT
CCCATGCTGTAAGCGTGGTA -> CCATGCTGTAAGCGTGGTAA
TGCCCATGGCTTTTCCTCAA -> GCCCATGGCTTTTCCTCAAT
GTGGTCTCATTTTATGTTTT -> TGGTCTCATTTTATGTTTTC
GTTACCATTGTAGTCGAGGG -> TTACCATTGTAGTCGAGGGT
TAATCTCCTTGCCTACTGGC -> AATCTCCTTGCCTACTGGCA
GTGTGGGTCAACGGTGAAAT -> TGTGGGTCAACGGTGAAATT
GGTTGCCACGTGGCGTGGCA -> GTTGCCACGTGGCGTGGCAG
GCAATACACGACTTGGCGCC -> CAATACACGACTTGGCGCCT
AGTGAATAACCCCTCGAGTA -> GTGAATAACCCCTCGAGTAA
TGGGGGGCTTACGCATTCTT -> GGGGGGCTTACGCATTCTTA
AGCAATACACGACTTGGCGC -> GCAATACACGACTTGGCGCC
CAATACACGACTTGGCGCCT -> AATACACGACTTGGCGCCTG
ACCTAAGTAGCAGCGCTGGG -> CCTAAGTAGCAGCGCTGGGG
ACGTCCGGATCACGTACGCG -> CGTCCGGATCACGTACGCGT
TCCGGATCACGTACGCGTAT -> CCGGATCACGTACGCGTATG
GTCTACAAGAATCATTCGTA -> TCTACAAGAATCATTCGTAA
AGGCCGACCCAGGTCTTGGT -> GGCCGACCCAGGTCTTGGTT
GGCTTACGATCACAGCAGTT -> GCTTACGATCACAGCAGTTT
GTGGCCCCGTTTCCCGCACG -> TGGCCCCGTTTCCCGCACGG
GCAAATTCCTCGGGACTATC -> CAAATTCCTCGGGACTATCA
GCCACGTGGCGTGGCAGATG -> CCACGTGGCGTGGCAGATGA
GAGTAAACGCACGTCGCGTA -> AGTAAACGCACGTCGCGTAC
GTGAATAACCCCTCGAGTAA -> TGAATAACCCCTCGAGTAAA
TTTTTATCCCTCTCATCCTA -> TTTTATCCCTCTCATCCTAC
AGGACTTATGCCGGATACGG -> GGACTTATGCCGGATACGGA
TGGTTTTTATCCCTCTCATC -> GGTTTTTATCCCTCTCATCC
CCTCGGGACTATCACTGACG -> CTCGGGACTATCACTGACGT
CCCGTAAGGACTCAACGCCT -> CCGTAAGGACTCAACGCCTG
GTCTTGGTTTTTATCCCTCT -> TCTTGGTTTTTATCCCTCTC
GCTTTTCCTCAATGCAGTTC -> CTTTTCCTCAATGCAGTTCG
GGAGTTACCATTGTAGTCGA -> GAGTTACCATTGTAGTCGAG
TTGCGTGTGGGTCAACGGTG -> TGCGTGTGGGTCAACGGTGA
CCCGTTTCCCGCACGGCACG -> CCGTTTCCCGCACGGCACGC
CATTGTAGTCGAGGGTCGAG -> ATTGTAGTCGAGGGTCGAGA
ATGTTTTCATATAGAGGACA -> TGTTTTCATATAGAGGACAG
GTCGAGGGTCGAGATGACAT -> TCGAGGGTCGAGATGACATT
GCGTGGCAGATGAACAGAAG -> CGTGGCAGATGAACAGAAGA
AAGGCACGCCAGTCTACAAG -> AGGCACGCCAGTCTACAAGA
TTCGATGGCGGCAAACTTGC -> TCGATGGCGGCAAACTTGCC
CAAATTCCTCGGGACTATCA -> AAATTCCTCGGGACTATCAC
CTGGAAATGTCCAAAATAAG -> TGGAAATGTCCAAAATAAGA
GACAGATAACTAGGTGTGCC -> ACAGATAACTAGGTGTGCCC
CGCACGGCACGCCTTGCGTG -> GCACGGCACGCCTTGCGTGT
TGGCACGCGTGGGGCATTAA -> GGCACGCGTGGGGCATTAAG
TCCAACCACGTATGAATGCC -> CCAACCACGTATGAATGCCC
ATCCTTAGACACGGCAAATT -> TCCTTAGACACGGCAAATTC
TTTATGTTTTCATATAGAGG -> TTATGTTTTCATATAGAGGA
GCTTATCCTTAGACACGGCA -> CTTATCCTTAGACACGGCAA
CATAGCCATACGGAGTTACC -> ATAGCCATACGGAGTTACCA
GACTTATGCCGGATACGGAA -> ACTTATGCCGGATACGGAAC
CCTCAATGCAGTTCGATGGC -> CTCAATGCAGTTCGATGGCG
GGATGTAGAGGCTGAGCGAC -> GATGTAGAGGCTGAGCGACA
CTGGGGTACATAAGGCACGC -> TGGGGTACATAAGGCACGCC
TGAGCCCAATGCGATCCAAC -> GAGCCCAATGCGATCCAACC
TCGGCTCGCGCGCTACATTC -> CGGCTCGCGCGCTACATTCT
TTTTCCTCAATGCAGTTCGA -> TTTCCTCAATGCAGTTCGAT
ACGGTTGCCACGTGGCGTGG -> CGGTTGCCACGTGGCGTGGC
TGCCCACCTAAGTAGCAGCG -> GCCCACCTAAGTAGCAGCGC
ACATAAGGCACGCCAGTCTA -> CATAAGGCACGCCAGTCTAC
AGTAAACGCACGTCGCGTAC -> GTAAACGCACGTCGCGTACT
GGGGTACATAAGGCACGCCA -> GGGTACATAAGGCACGCCAG
GCTCGCGCGCTACATTCTCA -> CTCGCGCGCTACATTCTCAC
TTGACCCGTAAGGACTCAAC -> TGACCCGTAAGGACTCAACG
TAGAGGCTGAGCGACAATTG -> AGAGGCTGAGCGACAATTGG
TAGTCTTACGTCCGGATCAC -> AGTCTTACGTCCGGATCACG
ACGCATTCTTACTGCACATG -> CGCATTCTTACTGCACATGG
ACGTATGAATGCCCACCTAA -> CGTATGAATGCCCACCTAAG
CACGTCGCGTACTAGGTTCC -> ACGTCGCGTACTAGGTTCCA
CACGGCACGCCTTGCGTGTG -> ACGGCACGCCTTGCGTGTGG
CGGCCAGGCTTACGATCACA -> GGCCAGGCTTACGATCACAG
GCTGTAGTCTTACGTCCGGA -> CTGTAGTCTTACGTCCGGAT
GACATTTTATAGTCCTACCA -> ACATTTTATAGTCCTACCAT
TCGTAAGCTGTAGTCTTACG -> CGTAAGCTGTAGTCTTACGT
CACGTATGAATGCCCACCTA -> ACGTATGAATGCCCACCTAA
CCCTCGAGTAAACGCACGTC -> CCTCGAGTAAACGCACGTCG
TCTCATCCTACCCCTTCTGT -> CTCATCCTACCCCTTCTGTT
TCTGCCACGACCAATAGTGA -> CTGCCACGACCAATAGTGAC
AATAAGAAGCATAGCCATAC -> ATAAGAAGCATAGCCATACG
TTTTATCCCTCTCATCCTAC -> TTTATCCCTCTCATCCTACC
CGACAATTGGATGGCGGCTA -> GACAATTGGATGGCGGCTAT
ATCCTACCCCTTCTGTTGAG -> TCCTACCCCTTCTGTTGAGC
ATTCCTCGGGACTATCACTG -> TTCCTCGGGACTATCACTGA
TTACTGCACATGGCCGCGCT -> TACTGCACATGGCCGCGCTC
CAAGAATCATTCGTAAGCTG -> AAGAATCATTCGTAAGCTGT
ATTTTATGTTTTCATATAGA -> TTTTATGTTTTCATATAGAG
CTGCACATGGCCGCGCTCAT -> TGCACATGGCCGCGCTCATC
GGTGAAATTAATGTTTCAAA -> GTGAAATTAATGTTTCAAAT
CACAGCAGTTTCCGATTCTT -> ACAGCAGTTTCCGATTCTTA
GCCCATGGCTTTTCCTCAAT -> CCCATGGCTTTTCCTCAATG
TCAGTGGCCCCGTTTCCCGC -> CAGTGGCCCCGTTTCCCGCA
TCCTACCCCTTCTGTTGAGC -> CCTACCCCTTCTGTTGAGCC
TACGCCATATACCTATAGAC -> ACGCCATATACCTATAGACA
TATACCTATAGACAGGCTTA -> ATACCTATAGACAGGCTTAT
CATGGCCGCGCTCATCGCTA -> ATGGCCGCGCTCATCGCTAA
CGCCAGTCTACAAGAATCAT -> GCCAGTCTACAAGAATCATT
GGCTTATCCTTAGACACGGC -> GCTTATCCTTAGACACGGCA
ACCAATAGTGACACAGATCT -> CCAATAGTGACACAGATCTT
GGTCTTGGTTTTTATCCCTC -> GTCTTGGTTTTTATCCCTCT
ACGGCACGCCTTGCGTGTGG -> CGGCACGCCTTGCGTGTGGG
GCGTAATCTCCTTGCCTACT -> CGTAATCTCCTTGCCTACTG
CAACGGTGAAATTAATGTTT -> AACGGTGAAATTAATGTTTC
CGGTGAAATTAATGTTTCAA -> GGTGAAATTAATGTTTCAAA
ACGTCGCGTACTAGGTTCCA -> CGTCGCGTACTAGGTTCCAG
GATGTAGAGGCTGAGCGACA -> ATGTAGAGGCTGAGCGACAA
TAAGCTGTAGTCTTACGTCC -> AAGCTGTAGTCTTACGTCCG
ACATTCTCACGCCCCATGCT -> CATTCTCACGCCCCATGCTG
CGTGGCAGATGAACAGAAGA -> GTGGCAGATGAACAGAAGAC
AAGACAGATAACTAGGTGTG -> AGACAGATAACTAGGTGTGC
CTGCCACGACCAATAGTGAC -> TGCCACGACCAATAGTGACA
ACCACGTATGAATGCCCACC -> CCACGTATGAATGCCCACCT
GCTGGGGTACATAAGGCACG -> CTGGGGTACATAAGGCACGC
GCGCTCATCGCTAACATAAC -> CGCTCATCGCTAACATAACG
CTGAGCGACAATTGGATGGC -> TGAGCGACAATTGGATGGCG
AATAGTGACACAGATCTTCT -> ATAGTGACACAGATCTTCTG
TAAGGCACGCCAGTCTACAA -> AAGGCACGCCAGTCTACAAG
ACTGACGTTCTGCCACGACC -> CTGACGTTCTGCCACGACCA
CTAGCGTTGACCCGTAAGGA -> TAGCGTTGACCCGTAAGGAC
AACTAGGTGTGCCCATGGCT -> ACTAGGTGTGCCCATGGCTT
ACTATCACTGACGTTCTGCC -> CTATCACTGACGTTCTGCCA
CGTGGCGTGGCAGATGAACA -> GTGGCGTGGCAGATGAACAG
CGTACGGTTGCCACGTGGCG -> GTACGGTTGCCACGTGGCGT
AGGATGTAGAGGCTGAGCGA -> GGATGTAGAGGCTGAGCGAC
CTCGAGTAAACGCACGTCGC -> TCGAGTAAACGCACGTCGCG
CACAGATCTTCTGGAAATGT -> ACAGATCTTCTGGAAATGTC
TTGAGCCCAATGCGATCCAA -> TGAGCCCAATGCGATCCAAC
ACAGCAGTTTCCGATTCTTA -> CAGCAGTTTCCGATTCTTAG
GTGGCGTGGCAGATGAACAG -> TGGCGTGGCAGATGAACAGA
TTCATATAGAGGACAGCCTT -> TCATATAGAGGACAGCCTTG
TCACTGACGTTCTGCCACGA -> CACTGACGTTCTGCCACGAC
CAGGTCTTGGTTTTTATCCC -> AGGTCTTGGTTTTTATCCCT
GTAGGCGTCATAGGCCGACC -> TAGGCGTCATAGGCCGACCC
CCGTTTCCCGCACGGCACGC -> CGTTTCCCGCACGGCACGCC
ATTCTTACTGCACATGGCCG -> TTCTTACTGCACATGGCCGC
TTCTTAGACAGGCGTAATCT -> TCTTAGACAGGCGTAATCTC
TGCCGCTCGTCTAGCGTTGA -> GCCGCTCGTCTAGCGTTGAC
ATAGAGGATGTAGAGGCTGA -> TAGAGGATGTAGAGGCTGAG
GGACTTATGCCGGATACGGA -> GACTTATGCCGGATACGGAA
ACAGAAGACAGATAACTAGG -> CAGAAGACAGATAACTAGGT
CAGGCGTAATCTCCTTGCCT -> AGGCGTAATCTCCTTGCCTA
CTCGTCTAGCGTTGACCCGT -> TCGTCTAGCGTTGACCCGTA
TCTAGAATGGTCCGTACGGT -> CTAGAATGGTCCGTACGGTT
ATCTCCTTGCCTACTGGCAC -> TCTCCTTGCCTACTGGCACG
CTTGCGTGTGGGTCAACGGT -> TTGCGTGTGGGTCAACGGTG
AGGTCTTGGTTTTTATCCCT -> GGTCTTGGTTTTTATCCCTC
GGCGGCTATCGGCTCGCGCG -> GCGGCTATCGGCTCGCGCGC
GTAAGCGTGGTAACCTGACA -> TAAGCGTGGTAACCTGACAA
GTCAGTGGCCCCGTTTCCCG -> TCAGTGGCCCCGTTTCCCGC
CTACTGGCACGCGTGGGGCA -> TACTGGCACGCGTGGGGCAT
CAATAGAGGATGTAGAGGCT -> AATAGAGGATGTAGAGGCTG
CCGTACGGTTGCCACGTGGC -> CGTACGGTTGCCACGTGGCG
TCACGCCCCATGCTGTAAGC -> CACGCCCCATGCTGTAAGCG
GGGGCATTAAGCCCGTGGTC -> GGGCATTAAGCCCGTGGTCT
GAAGCATAGCCATACGGAGT -> AAGCATAGCCATACGGAGTT
ATGACATTTTATAGTCCTAC -> TGACATTTTATAGTCCTACC
GCCAGGCTTACGATCACAGC -> CCAGGCTTACGATCACAGCA
GTAAGCTGTAGTCTTACGTC -> TAAGCTGTAGTCTTACGTCC
CACGACTTGGCGCCTGGGGG -> ACGACTTGGCGCCTGGGGGG
ATAGGCCGACCCAGGTCTTG -> TAGGCCGACCCAGGTCTTGG
TACCATCTAGAATGGTCCGT -> ACCATCTAGAATGGTCCGTA
ATGTTTCAAATATTTAGCAT -> TGTTTCAAATATTTAGCATC
CTAGGTTCCAGGACTTATGC -> TAGGTTCCAGGACTTATGCC
TGTAGTCGAGGGTCGAGATG -> GTAGTCGAGGGTCGAGATGA
AGTCTACAAGAATCATTCGT -> GTCTACAAGAATCATTCGTA
GCACATGGCCGCGCTCATCG -> CACATGGCCGCGCTCATCGC
TTGTACGCCATATACCTATA -> TGTACGCCATATACCTATAG
TGAAAAGCTGGTAGGTAGGC -> GAAAAGCTGGTAGGTAGGCG
ATTCGTAAGCTGTAGTCTTA -> TTCGTAAGCTGTAGTCTTAC
GTAGTCGAGGGTCGAGATGA -> TAGTCGAGGGTCGAGATGAC
TACCCCTTCTGTTGAGCCCA -> ACCCCTTCTGTTGAGCCCAA
CTCAATGCAGTTCGATGGCG -> TCAATGCAGTTCGATGGCGG
GAAATTAATGTTTCAAATAT -> AAATTAATGTTTCAAATATT
ATCCCTCTCATCCTACCCCT -> TCCCTCTCATCCTACCCCTT
GTGGGTCAACGGTGAAATTA -> TGGGTCAACGGTGAAATTAA
ATAACTAGGTGTGCCCATGG -> TAACTAGGTGTGCCCATGGC
TCTCACGCCCCATGCTGTAA -> CTCACGCCCCATGCTGTAAG
TACCTGTAGCAATACACGAC -> ACCTGTAGCAATACACGACT
CTTGTACGCCATATACCTAT -> TTGTACGCCATATACCTATA
GCGTACTAGGTTCCAGGACT -> CGTACTAGGTTCCAGGACTT
CATCCTACCCCTTCTGTTGA -> ATCCTACCCCTTCTGTTGAG
AGAATGGTCCGTACGGTTGC -> GAATGGTCCGTACGGTTGCC
TGGCAGATGAACAGAAGACA -> GGCAGATGAACAGAAGACAG
ACTAGGTTCCAGGACTTATG -> CTAGGTTCCAGGACTTATGC
AATAACCCCTCGAGTAAACG -> ATAACCCCTCGAGTAAACGC
GGGTCAACGGTGAAATTAAT -> GGTCAACGGTGAAATTAATG
CGTCGCGTACTAGGTTCCAG -> GTCGCGTACTAGGTTCCAGG
TAGCCATACGGAGTTACCAT -> AGCCATACGGAGTTACCATT
CAGTGGCCCCGTTTCCCGCA -> AGTGGCCCCGTTTCCCGCAC